TGTGCCAGCAGCTATTGGAAGGACTATGAGACCCAGTACTTC	CASSYWKDYETQYF	TRBV13	TRBJ2-5
TGCGCCAGCAGCCATCCGTCAGGGGGCTGGAAAGACTATGGCTACACCTTC	CASSHPSGGWKDYGYTF	TRBV4-1	TRBJ1-2
TGTGCCAGCAGTATCCTACGGGGAGCAGCATGGTGGAAGGACTATGGCTACACCTTC	CASSILRGAAWWKDYGYTF	TRBV6-6	TRBJ1-2
TGTGCCAGCAGCGTCCCTAGCTGGAAGGACTACGAGCAGTACTTC	CASSVPSWKDYEQYF	TRBV13	TRBJ2-7
TGTGCCAGCAGGGACTATTGGAAGGACTATGGCTACACCTTC	CASRDYWKDYGYTF	TRBV6-2	TRBJ1-2
TGTGCCAGCACCCCCCTACCGTGGAAAGACTATGGCTACACCTTC	CASTPLPWKDYGYTF	TRBV11-2	TRBJ1-2
TGCGCCAGCAGCTTGGAAGTCAGGGCCTGGAAGGACTATGGCTACACCTTC	CASSLEVRAWKDYGYTF	TRBV5-1	TRBJ1-2
TGTGCCAGCAGCCAAGACCCACGGGGGGGCCCATGGAAGGACTACGAGCAGTACTTC	CASSQDPRGGPWKDYEQYF	TRBV14	TRBJ2-7
TGTGCCTGGAAAGATTACATTGGTAGTAAGACCTACGAGCAGTACTTC	CAWKDYIGSKTYEQYF	TRBV30	TRBJ2-7
TGCAGCGAAGTCCCCTGGAAGGACTATGGCTACACCTTC	CSEVPWKDYGYTF	TRBV29-1	TRBJ1-2
TGTGCCAGCAGCCCCACGAGATGGAAGGACTATGGCTACACCTTC	CASSPTRWKDYGYTF	TRBV7-9	TRBJ1-2
TGTGCCAGCAGCTTGCGGCCCCTCTTACTAGCGGGAGGCTGGAAAGACTATGGCTACACCTTC	CASSLRPLLLAGGWKDYGYTF	TRBV5-4	TRBJ1-2
TGTGCCAGCAGGGGGGTATGGAAAGACTATGGCTACACCTTC	CASRGVWKDYGYTF	TRBV6-5	TRBJ1-2
TGCAGTGCTAGAGGTTGGAAAGACTACTCCTACAATGAGCAGTTCTTC	CSARGWKDYSYNEQFF	TRBV20-1	TRBJ2-1
TGTGCCAGCAGTAGAAATTGGAAGGACTATACGCAGTATTTT	CASSRNWKDYTQYF	TRBV12-3	TRBJ2-3
TGTGCCAGCAGCCGGTCTTGGAAGGACTACGAGCAGTACTTC	CASSRSWKDYEQYF	TRBV9	TRBJ2-7
TGCAGTGCTAGAGCCCCGGGACATTGGAAGGACTATGGCTACACCTTC	CSARAPGHWKDYGYTF	TRBV20-1	TRBJ1-2
TGTGCCAGCAGCAAATGGAAGGACTACGAGCAGTACTTC	CASSKWKDYEQYF	TRBV11-2	TRBJ2-7
TGTGCCAGCAGTTGGAAGGACTATATATCCTACTACGAGCAGTACTTC	CASSWKDYISYYEQYF	TRBV2	TRBJ2-7
TGTGCCAGCAGCAAGGGCTACTGGAAGGACTATGGCTACACCTTC	CASSKGYWKDYGYTF	TRBV13	TRBJ1-2
TGTGCCAGCAGTTTAGGTAGATGGAAGGACTACGAGCAGTACTTC	CASSLGRWKDYEQYF	TRBV12-4	TRBJ2-7
TGTGCCAGCAGCCTACTAGCGGGAGCCTTTTGGAAAGACTATGGCTACACCTTC	CASSLLAGAFWKDYGYTF	TRBV28	TRBJ1-2
TGCAGTGCTGGTAGGGGGATGAAGTGGAAAGACTATGGCTACACCTTC	CSAGRGMKWKDYGYTF	TRBV20-1	TRBJ1-2
TGTGCCAGCAGTTTAGAGCGGGACTACGGGGGGTGGAAAGACTACGAGCAGTACTTC	CASSLERDYGGWKDYEQYF	TRBV27	TRBJ2-7
TGCAGTGCCAGGAGTGCTTGGAAAGACTATGGCTACACCTTC	CSARSAWKDYGYTF	TRBV20-1	TRBJ1-2
TGCAGTGCTAGATTCAGTTGGAAGGACTACGAGCAGTACTTC	CSARFSWKDYEQYF	TRBV20-1	TRBJ2-7
TGCGCCAGCAGCCAAGACTGGAAGGACTACGAGCAGTACTTC	CASSQDWKDYEQYF	TRBV4-3	TRBJ2-7
TGTGCCAGCAGCCAAGTGGAATGGAAAGACTACGAGCAGTACTTC	CASSQVEWKDYEQYF	TRBV3-1	TRBJ2-7
TGTGCCAGCAGTTTAGGTGGCAGGCGTTTTCTTTGGAAGGACTACGAGCAGTACTTC	CASSLGGRRFLWKDYEQYF	TRBV12-3	TRBJ2-7
TGTGCCAGCAACGCGGACGCTTGGAAGGACTATGGCTACACCTTC	CASNADAWKDYGYTF	TRBV7-9	TRBJ1-2
TGTGCCAGCAGATGGGGGCCTTGGAAGGACTACACCGGGGAGCTGTTTTTT	CASRWGPWKDYTGELFF	TRBV6-2	TRBJ2-2
TGTGCCAGCAGCTCATTCAGGATCACCTGGAAGGACTATGGCTACACCTTC	CASSSFRITWKDYGYTF	TRBV7-6	TRBJ1-2
TGCAGTGCTAGCGGACAGTGGAAGGACTATGGCTACACCTTC	CSASGQWKDYGYTF	TRBV20-1	TRBJ1-2
TGCGCCAGCAGCTTGTACCCCGTTTGGGACAGCCCCCGGTGGAAGGACTACGAGCAGTACTTC	CASSLYPVWDSPRWKDYEQYF	TRBV5-1	TRBJ2-7
TGTGCCAGCACGACATCCTGGAAAGACTATGGCTACACCTTC	CASTTSWKDYGYTF	TRBV27	TRBJ1-2
TGCGCCAGCAGTGATAGAAAGGGTTGGAAAGACTACTATGGCTACACCTTC	CASSDRKGWKDYYGYTF	TRBV10-1	TRBJ1-2
TGTGCCAGCCACCTTGGGACAGGGTGGAAGGACTATGGCTACACCTTC	CASHLGTGWKDYGYTF	TRBV28	TRBJ1-2
TGCAGTGCTAGAGATCCCGTAGGACAGGCCTGGAAAGACTATAGCAATCAGCCCCAGCATTTT	CSARDPVGQAWKDYSNQPQHF	TRBV20-1	TRBJ1-5
TGTGCTAGTGGTTTGTGCCCTTGCAGGGGATGGAAAGACTACGAGCAGTACTTC	CASGLCPCRGWKDYEQYF	TRBV12-5	TRBJ2-7
TGTGCCTGGAAAGACTATGGCTACACCTTC	CAWKDYGYTF	TRBV30	TRBJ1-2
TGCGCCAGCAGTGAGAAGTGGAAGGACTACGAGCAGTACTTC	CASSEKWKDYEQYF	TRBV10-2	TRBJ2-7
TGCGCCAGCAGCTTGGGTAGATGGAAGGATTACAATGAGCAGTTCTTC	CASSLGRWKDYNEQFF	TRBV5-1	TRBJ2-1
TGTGCCAGCAGTGAAGAGTGGAAGGACTACAATGAGCAGTTCTTC	CASSEEWKDYNEQFF	TRBV6-2	TRBJ2-1
TGCAGTGCTTTTCCGGACAGGGATACCGTCCTCTGGAAAGACTATGGCTACACCTTC	CSAFPDRDTVLWKDYGYTF	TRBV20-1	TRBJ1-2
TGTGCCAGCAGCCGACCTCCGGGGTGGAAAGACTATGGCTACACCTTC	CASSRPPGWKDYGYTF	TRBV7-3	TRBJ1-2
TGTGCCAGGACCTGGAAGGACTATGGCTACACCTTC	CARTWKDYGYTF	TRBV7-9	TRBJ1-2
TGTGCCAGCAGTGACTCTTGGAAAGACTACGAGCAGTACTTC	CASSDSWKDYEQYF	TRBV6-4	TRBJ2-7
TGTGCCAGCAGTTGGAAGGACTATCTCACAGATACGCAGTATTTT	CASSWKDYLTDTQYF	TRBV27	TRBJ2-3
TGTGCCAGCAGCCTATGGAAAGACTACACTGAAGCTTTCTTT	CASSLWKDYTEAFF	TRBV13	TRBJ1-1
TGTGCCACCAGGTATCCCACATGGAAAGACTATGGCTACACCTTC	CATRYPTWKDYGYTF	TRBV24-1	TRBJ1-2
TGTGCCTGGAAGGACTATGGAACTGAAGCTTTCTTT	CAWKDYGTEAFF	TRBV30	TRBJ1-1
TGTGCCTGGAAGGATTACCGACAGGGGGCCACCGGGTTAGTTTTGCCCCAGCATTTT	CAWKDYRQGATGLVLPQHF	TRBV30	TRBJ1-5
TGTGCCAGCAGCGATAGGGGCTGGAAGGACTACGAGCAGTACTTC	CASSDRGWKDYEQYF	TRBV12-3	TRBJ2-7
TGTGCCAGCAGCGAAGGCGTTCGGTGGAAGGACTATGGCTACACCTTC	CASSEGVRWKDYGYTF	TRBV7-3	TRBJ1-2
TGCGCCAGCAGCCAAGTGGACAGGGAATGGAAGGACTATGGCTACACCTTC	CASSQVDREWKDYGYTF	TRBV4-1	TRBJ1-2
TGTGCTAGTGGACCCGTGACAGCCTGGAAGGACTACGAGCAGTACTTC	CASGPVTAWKDYEQYF	TRBV12-5	TRBJ2-7
TGTGCCTGGAAGGACTACTCTAGGAGCTCCTACAATGAGCAGTTCTTC	CAWKDYSRSSYNEQFF	TRBV30	TRBJ2-1
TGTGCCAGCAATGGACAGCGGACTTGGAAGGACTATGGCTACACCTTC	CASNGQRTWKDYGYTF	TRBV5-6	TRBJ1-2
TGTGCCAGCGACTGGAAGGACTATGGCTACACCTTC	CASDWKDYGYTF	TRBV3-1	TRBJ1-2
TGTGCCAGCAGCGGAGACCCCCCGGGGGGGCAGTGGAAGGACTACGAGCAGTACTTC	CASSGDPPGGQWKDYEQYF	TRBV7-4	TRBJ2-7
TGTGCCAGCAGTTTATTGATCCGCCGTGGTTGGAAAGACTATGGCTACACCTTC	CASSLLIRRGWKDYGYTF	TRBV28	TRBJ1-2
TGTGCCCACCCAGCTTGGAAGGACTACAATGAGCAGTTCTTC	CAHPAWKDYNEQFF	TRBV3-1	TRBJ2-1
TGTGCCAGCATCTGGAAAGATTACGAGCAGTACTTC	CASIWKDYEQYF	TRBV12-3	TRBJ2-7
TGTGCCAGCAGTTACTCGAGCCGTGAAGGGGACAGGGAGAAAATTGGCTGGAAGGACTACGAGCAGTACTTC	CASSYSSREGDREKIGWKDYEQYF	TRBV6-3	TRBJ2-7
TGTGCCCCTTTTTGGAAGGATTACACCTTC	CAPFWKDYTF	TRBV27	TRBJ1-2
TGTGCCAGCAATCAGGGGGGGTGGAAAGACTATGGCTACACCTTC	CASNQGGWKDYGYTF	TRBV6-4	TRBJ1-2
TGTGCCACCAGCAGAGATGGGGGACAGTCCTGGAAGGACTATGGCTACACCTTC	CATSRDGGQSWKDYGYTF	TRBV15	TRBJ1-2
TGTGCCAGTAGTATAGAGTGGGGACAGTGGAAGGATTATAGCAATCAGCCCCAGCATTTT	CASSIEWGQWKDYSNQPQHF	TRBV19	TRBJ1-5
TGTGCCAGCCACCTCTCCTCTTGGAAGGACTACGAGCAGTACTTC	CASHLSSWKDYEQYF	TRBV5-5	TRBJ2-7
TGCGCCAGCAGCCAACCCAGACAGGGGGAGTGCTGGAAGGACTATGGCTACACCTTC	CASSQPRQGECWKDYGYTF	TRBV5-1	TRBJ1-2
TGTGCCAGCAGTCTCCTAGGATGGAAGGACTACGAGCAGTACTTC	CASSLLGWKDYEQYF	TRBV6-1	TRBJ2-7
TGTGCCAGCAGCGGCCTGTGGAAGGACTACAATGAGCAGTTCTTC	CASSGLWKDYNEQFF	TRBV5-4	TRBJ2-1
TGTGCCAGCAGTTTAGGTCTAGAGTGGAAAGACTATGGCTACACCTTC	CASSLGLEWKDYGYTF	TRBV6-1	TRBJ1-2
TGTGCCAGCAGCTCCTCTGACGGAGACAGGTGGAAAGACTATGGCTACACCTTC	CASSSSDGDRWKDYGYTF	TRBV5-6	TRBJ1-2
TGTGCCATCAGTGATGGGGGGCCCTTGTGGAAGGACTATGGCTACACCTTC	CAISDGGPLWKDYGYTF	TRBV10-3	TRBJ1-2
TGTGCCAGCAGCCCTTGGAAGGATTACTGGGAGGCCGTGTCGGAAAAACTGTTTTTT	CASSPWKDYWEAVSEKLFF	TRBV5-6	TRBJ1-4
TGTGCCAGCAGTTCCTTCGGACTGGGGGACAGCTGGAAAGACTACGAGCAGTACTTC	CASSSFGLGDSWKDYEQYF	TRBV27	TRBJ2-7
TGTGCCAGCAGCCTGACAGGGGGCTGGAAAGACTATGGCTACACCTTC	CASSLTGGWKDYGYTF	TRBV11-3	TRBJ1-2
TGTGCCAGCTCACCGCGACTAGCGGGCTGGAAGGACTACGAGCAGTACTTC	CASSPRLAGWKDYEQYF	TRBV18	TRBJ2-7
TGCGCCAGCAGCCGGGGATGGAAAGACTACGAGCAGTACTTC	CASSRGWKDYEQYF	TRBV5-1	TRBJ2-7
TGTGCCAGCAAAGGTCGAGTGTGGAAAGACTACGAGCAGTACTTC	CASKGRVWKDYEQYF	TRBV5-6	TRBJ2-7
TGTGCCAGCAGTTACTCGCGGGGTTGGAAAGACTATGGCTACACCTTC	CASSYSRGWKDYGYTF	TRBV6-2	TRBJ1-2
TGTGCCAGCAGCCTGCCTTTGGACCCCTGGAAGGACTATGGCTACACCTTC	CASSLPLDPWKDYGYTF	TRBV13	TRBJ1-2
TGTGCCAGTAGTATAGGGTCACCCCCGGGGTGGAAGGACTATGGCTACACCTTC	CASSIGSPPGWKDYGYTF	TRBV19	TRBJ1-2
TGCGCCAGCCCTTGGGGATGGAAAGACTACGAGCAGTACTTC	CASPWGWKDYEQYF	TRBV10-1	TRBJ2-7
TGTGCCAGCGGGTGGTGGGGGGGCTGGAAAGACTACGAGCAGTACTTC	CASGWWGGWKDYEQYF	TRBV7-8	TRBJ2-7
TGTGCCTGGACTTGGAAAGACTACGAGCAGTACTTC	CAWTWKDYEQYF	TRBV30	TRBJ2-7
TGTGCCATTGGGGCCCAGTGGAAGGACTACGAGCAGTACTTC	CAIGAQWKDYEQYF	TRBV12-3	TRBJ2-7
TGTGCCAGCAGGGCGGGGACTAGCGGGCTCTGGAAAGACTACGAGCAGTACTTC	CASRAGTSGLWKDYEQYF	TRBV9	TRBJ2-7
TGTGCCAGCAGCGCTCAGGGGATAGGGCGATGGAAAGACTACGAGCAGTACTTC	CASSAQGIGRWKDYEQYF	TRBV9	TRBJ2-7
TGCAGTGCAGGACAGTGGAAAGACTATGGCTACACCTTC	CSAGQWKDYGYTF	TRBV20-1	TRBJ1-2
TGTGCCAGCAGCCAAGTCCGTGCGGACTGGAAGGACTATGGCTACACCTTC	CASSQVRADWKDYGYTF	TRBV3-1	TRBJ1-2
TGTGCCAGCGTAACCCCCGGGACATGGAAGGACTACGAGCAGTACTTC	CASVTPGTWKDYEQYF	TRBV7-8	TRBJ2-7
TGTGCCAGCAGCCAAGTTTCCTGGAAGGACTACGAGCAGTACTTC	CASSQVSWKDYEQYF	TRBV14	TRBJ2-7
TGTGCCAGCAGTGGACTCCGGACTAGCGGGTGGAAGGACTACAATGAGCAGTTCTTC	CASSGLRTSGWKDYNEQFF	TRBV6-5	TRBJ2-1
TGTGCCAGCAGGCCCCGCTGCTGGAAGGACTACGAGCAGTACTTC	CASRPRCWKDYEQYF	TRBV2	TRBJ2-7
TGTGCCAGCAGTTACACCGGGACTAGCGGGAGGTGGAAAGACTACGAGCAGTACTTC	CASSYTGTSGRWKDYEQYF	TRBV6-4	TRBJ2-7
TGTGCCAGCAGAAGGTTAGGGACAGGAAAATGGAAGGATTACACTGAAGCTTTCTTT	CASRRLGTGKWKDYTEAFF	TRBV6-2	TRBJ1-1
TGTGCCAGCAGCATCCGAGGGTGGAAGGACTATGGCTACACCTTC	CASSIRGWKDYGYTF	TRBV9	TRBJ1-2
TGCGCCAGCAGGACTAGCGAGTGGAAGGATTATGAGCAGTTCTTC	CASRTSEWKDYEQFF	TRBV5-1	TRBJ2-1
TGTGCCAGCAGTTTGGAGACAGGGGCCTGGAAAGACTATGGCTACACCTTC	CASSLETGAWKDYGYTF	TRBV28	TRBJ1-2
TGTGCCAGTAGTATGAAGCGGGAGTGGAAGGACTACGAGCAGTACTTC	CASSMKREWKDYEQYF	TRBV19	TRBJ2-7
TGTGCCTGGAAGGACTATGCAAGCTCCTACAATGAGCAGTTCTTC	CAWKDYASSYNEQFF	TRBV30	TRBJ2-1
TGTGCCAGCAGTGACTTCGAAGATTGGAAAGACTATCAGCCCCAGCATTTT	CASSDFEDWKDYQPQHF	TRBV6-4	TRBJ1-5
TGTGCCAGCAGCTTGAGACCCTTCCTTCGGCCTTGGAAAGACTATGGCTACACCTTC	CASSLRPFLRPWKDYGYTF	TRBV11-3	TRBJ1-2
TGTGCTAGCAGCTTACCCTCCCGGCGGTGGAAAGACTATGGCTACACCTTC	CASSLPSRRWKDYGYTF	TRBV7-7	TRBJ1-2
TGTGCCACCAGGTGGAAGGACTACGAGCAGTACTTC	CATRWKDYEQYF	TRBV24-1	TRBJ2-7
TGTGCCATCAGTGAGTCCGAGGACAGTGGTTGGAAAGACTATGGCTACACCTTC	CAISESEDSGWKDYGYTF	TRBV10-3	TRBJ1-2
TGTGCCATCAGTCCATGGAAGGACTATAGCAATCAGCCCCAGCATTTT	CAISPWKDYSNQPQHF	TRBV10-3	TRBJ1-5
TGTGCCAGCAGTTACTCTAGGGAGGTCGTCAGTTGGAAAGACTATGGCTACACCTTC	CASSYSREVVSWKDYGYTF	TRBV6-2	TRBJ1-2
TGTGCCTGGAAGGACTACCCCCCCGACAGGGGGGGGGGGGGGTACAATGAGCAGTTCTTC	CAWKDYPPDRGGGGYNEQFF	TRBV30	TRBJ2-1
TGTGCCAGCCGCTGCGGGGACTGGAAGGACTACGAGCAGTACTTC	CASRCGDWKDYEQYF	TRBV6-1	TRBJ2-7
TGTGCCATGCCATGGAAGGACTATGGCTACACCTTC	CAMPWKDYGYTF	TRBV6-5	TRBJ1-2
TGTGCCACCAGTGATTTCCGGGAGGGTTGGAAGGACTACGAGCAGTACTTC	CATSDFREGWKDYEQYF	TRBV24-1	TRBJ2-7
TGTGCTAGTGGCATTCCGGGGGAGCAGTGGAAAGACTATGGCTACACCTTC	CASGIPGEQWKDYGYTF	TRBV12-5	TRBJ1-2
TGTGCCAGCAGCTGGAAGGACTACTATGGCTACACCTTC	CASSWKDYYGYTF	TRBV7-2	TRBJ1-2
TGTGCCAGCAGCTTATGGGGGTTTTGGAAGGACTACGAGCAGTACTTC	CASSLWGFWKDYEQYF	TRBV7-3	TRBJ2-7
TGTGCCAGCAGTGAGGTAGGGGGGTGGAAAGATTACAATGAGCAGTTCTTC	CASSEVGGWKDYNEQFF	TRBV25-1	TRBJ2-1
TGTGCCAGCAGCCCGGGGTGGAAGGACTACGAGCAGTACTTC	CASSPGWKDYEQYF	TRBV11-3	TRBJ2-7
TGCGCCAGCAGCTTGGCCGGACGGGGGTGGAAGGACTACGAGCAGTACTTC	CASSLAGRGWKDYEQYF	TRBV5-1	TRBJ2-7
TGTGCCAGCAGCTCCATACGTTGGAAAGATTATGGCTACACCTTC	CASSSIRWKDYGYTF	TRBV5-6	TRBJ1-2
TGCAGTGCGAACTGGAAGGATTACACTGAAGCTTTCTTT	CSANWKDYTEAFF	TRBV20-1	TRBJ1-1
TGCGCCAGGGAATGGGGATGGAAAGACTATGGCTACACCTTC	CAREWGWKDYGYTF	TRBV10-1	TRBJ1-2
TGTGCCACCACAGGACCGGCCGGGACAGGGTGGAAGGACTATGGCTACACCTTC	CATTGPAGTGWKDYGYTF	TRBV24-1	TRBJ1-2
TGTGCCAGCAGCCAAAGAGTGATTCACCGGCGTAGAAACCGGGACAGTAGGTGGAAGGACTATGGCTACACCTTC	CASSQRVIHRRRNRDSRWKDYGYTF	TRBV3-1	TRBJ1-2
TGCGCCAGCAGTGGGGTATGGAAGGACTACGAGCAGTACTTC	CASSGVWKDYEQYF	TRBV10-1	TRBJ2-7
TGCGCCAGCAGGCCCTGGAAGGACTACGAGCAGTACTTC	CASRPWKDYEQYF	TRBV10-1	TRBJ2-7
TGTGCCAGCAGAAGTCACAGGGGGCCTTGGAAGGACTACGAGCAGTACTTC	CASRSHRGPWKDYEQYF	TRBV5-5	TRBJ2-7
TGCGCCAGCAGTAGGGGGCGCTGGAAAGATTATTCGGCCGAGCAGTACTTC	CASSRGRWKDYSAEQYF	TRBV10-1	TRBJ2-7
TGTGCCAGCTCACCACGTGGGGCCAAGTGGAAAGACTATGGCTACACCTTC	CASSPRGAKWKDYGYTF	TRBV18	TRBJ1-2
TGTGCCAGAAGCGAATCAGGGTGGAAGGACTATGGCTACACCTTC	CARSESGWKDYGYTF	TRBV5-5	TRBJ1-2
TGTGCCAGTAGTAGGGAAGTTAAGTGGAAAGACTATGGCTACACCTTC	CASSREVKWKDYGYTF	TRBV19	TRBJ1-2
TGTGCCAGCAGTTTATCGTTTTGGAAGGACTATGAAAAACTGTTTTTT	CASSLSFWKDYEKLFF	TRBV27	TRBJ1-4
TGTGCCAGCAGCTTTCCAGGGACATGGAAAGACTACGAGCAGTACTTC	CASSFPGTWKDYEQYF	TRBV7-6	TRBJ2-7
TGTGCCAGTAGTCGACTAGACAGGGAGTGGAAGGACTACGAGCAGTACTTC	CASSRLDREWKDYEQYF	TRBV19	TRBJ2-7
TGTGCCAGCAGTCGAAAATGGGGGCAGGGGGGTTTTCGTTGGAAAGACTACGAGCAGTACTTC	CASSRKWGQGGFRWKDYEQYF	TRBV27	TRBJ2-7
TGTGCCTGGAAAGACTACTACGAGCAGTACTTC	CAWKDYYEQYF	TRBV30	TRBJ2-7
TGTGCCAGCAGTTTAAGATTAGCGGGATGGAAGGACTACGAGCAGTACTTC	CASSLRLAGWKDYEQYF	TRBV28	TRBJ2-7
TGTGCCAGCAGTTTCCTTCTAGCGGGTTGGAAGGACTACGAGCAGTACTTC	CASSFLLAGWKDYEQYF	TRBV27	TRBJ2-7
TGTGCGCCAACGCTGTGGTGGAAAGACTACGAGCAGTACTTC	CAPTLWWKDYEQYF	TRBV24-1	TRBJ2-7
TGTGCCAGCAGTTTAGTCCCGGCCGGATGGAAGGACTATGGCTACACCTTC	CASSLVPAGWKDYGYTF	TRBV12-3	TRBJ1-2
TGTGCCACCAGTGATTTGGGCCGGGACAGGGGTTGGAAGGATTACCTGAACACTGAAGCTTTCTTT	CATSDLGRDRGWKDYLNTEAFF	TRBV24-1	TRBJ1-1
TGCGCCAGCAGCGCACGACAGGGATGGAAAGACTATGGCTACACCTTC	CASSARQGWKDYGYTF	TRBV5-1	TRBJ1-2
TGTGCCAGCAGTTACTCCTGGAAGGACTATGGCTACACCTTC	CASSYSWKDYGYTF	TRBV6-5	TRBJ1-2
TGTGCCAGCAGTTTATCGGCGGGCACTGCGCTGTGGAAGGACTACGAGCAGTACTTC	CASSLSAGTALWKDYEQYF	TRBV27	TRBJ2-7
TGTGCCAGCAGAAGTCTCATCCCCCCGGGTTGGAAGGACTATGGCTACACCTTC	CASRSLIPPGWKDYGYTF	TRBV28	TRBJ1-2
TGCAGTGCTTGGAAGGACTATGGGCAGTTCTTC	CSAWKDYGQFF	TRBV20-1	TRBJ2-1
TGTGCCTGGAGTGTACACCCCTGGAAGGACTACGAGCAGTACTTC	CAWSVHPWKDYEQYF	TRBV30	TRBJ2-7
TGTGCCAGCAGTTTAGGGTCCAGGGGTTGGAAGGACTACGAGCAGTACTTC	CASSLGSRGWKDYEQYF	TRBV28	TRBJ2-7
TGTGCCAGCAGCGGGGGCAAGTGGAAAGACTATGGCTACACCTTC	CASSGGKWKDYGYTF	TRBV9	TRBJ1-2
TGTGCCAGCAGCCGGGGCGGGAAATGGTGGAAGGACTATGGCTACACCTTC	CASSRGGKWWKDYGYTF	TRBV11-2	TRBJ1-2
TGTGCCAGCAGTAAACGACAGGGGGGGGGACCGCAGGAGTGGAAAGACTATGGCTACACCTTC	CASSKRQGGGPQEWKDYGYTF	TRBV6-5	TRBJ1-2
TGTGCCAGCACCCCCAGGGGGCGCCCCTGGAAGGACTATGGCTACACCTTC	CASTPRGRPWKDYGYTF	TRBV28	TRBJ1-2
TGTGCCAGCACCGAGACAGGGTGGAAAGACTATGGCTACACCTTC	CASTETGWKDYGYTF	TRBV27	TRBJ1-2
TGTGCCAGCAATATCAACAGGTGGAAGGACTACGAGCAGTACTTC	CASNINRWKDYEQYF	TRBV6-4	TRBJ2-7
TGTGCCAGCAGGGGTTCCGGCTGGAAAGACTATGGCTACACCTTC	CASRGSGWKDYGYTF	TRBV6-4	TRBJ1-2
TGCAGTGCTTTGAGGAACTGGAAAGACTATGGCTACACCTTC	CSALRNWKDYGYTF	TRBV20-1	TRBJ1-2
TGTGCCAGCACACACCCCCGGGACAGGTGGAAGGACTATGGCTACACCTTC	CASTHPRDRWKDYGYTF	TRBV9	TRBJ1-2
TGTGCCAGCAGCGGGTGGAAGGACTATGGCTACACCTTC	CASSGWKDYGYTF	TRBV5-5	TRBJ1-2
TGTGCCAGCAGCTTCCACTACTCCTGGAAAGACTACGAGCAGTACTTC	CASSFHYSWKDYEQYF	TRBV7-9	TRBJ2-7
TGCGCCAGCAGCCACTACGGGCTTTGGAAGGACTATGAAAAACTGTTTTTT	CASSHYGLWKDYEKLFF	TRBV4-3	TRBJ1-4
TGCGCCAGCAGCTGGAAGGACTACCTTATAAAGGTAGCGTACGAGCAGTACTTC	CASSWKDYLIKVAYEQYF	TRBV5-1	TRBJ2-7
TGTGCCAGCAGCGGAGGGTGGAAGGATTACGAGCAGTACTTC	CASSGGWKDYEQYF	TRBV9	TRBJ2-7
TGTGCCAGCAGCTGGTGGAAGGACTACACAGATACGCAGTATTTT	CASSWWKDYTDTQYF	TRBV5-6	TRBJ2-3
TGTGCCAGCGGCAGTAACAGGGCCTGGAAGGACTATGGCTACACCTTC	CASGSNRAWKDYGYTF	TRBV6-3	TRBJ1-2
TGTGCCAGCCACAGTGCGGGAGACTGGAAGGACTACGAGCAGTACTTC	CASHSAGDWKDYEQYF	TRBV27	TRBJ2-7
TGCGCCAGCAGTGAGTGCTGGAAAGACTATGGCTACACCTTC	CASSECWKDYGYTF	TRBV10-2	TRBJ1-2
TGTGCCAGCAGTGACAGTTGGAAAGATTACAATGAGCAGTTCTTC	CASSDSWKDYNEQFF	TRBV25-1	TRBJ2-1
TGTGCCAGCAGCTTTATCCGGGACAGTGTATGGAAGGACTATGGCTACACCTTC	CASSFIRDSVWKDYGYTF	TRBV7-2	TRBJ1-2
TGTGCCAGCAGCTTAGATAATTCGGGAGGGCCCTGGAAAGATTACGAGCAGTACTTC	CASSLDNSGGPWKDYEQYF	TRBV7-9	TRBJ2-7
TGTGCCACCAGTGATTTGTCCAGACCGGGACAGACCTGGAAGGACTACGAGCAGTACTTC	CATSDLSRPGQTWKDYEQYF	TRBV24-1	TRBJ2-7
TGTGCCTGGAGTGAACAGGGGGACTGGAAGGACTATGGCTACACCTTC	CAWSEQGDWKDYGYTF	TRBV30	TRBJ1-2
TGTGCCAGCAGCCAGTTCGAGTGGAAAGACTACGAGCAGTACTTC	CASSQFEWKDYEQYF	TRBV11-3	TRBJ2-7
TGTGCCTGGAGTGTAGGATGGAAGGATTATAGCAATCAGCCCCAGCATTTT	CAWSVGWKDYSNQPQHF	TRBV30	TRBJ1-5
TGCGCCAGCAGCTTGGGGTCCGCTTGCTGGAAGGACTACGAGCAGTACTTC	CASSLGSACWKDYEQYF	TRBV5-1	TRBJ2-7
TGTGCCACCAGCAACTCATGGAAAGACTACGAGCAGTACTTC	CATSNSWKDYEQYF	TRBV24-1	TRBJ2-7
TGTGCCAGCTCACCACCCGGGACAGGGTGGAAAGACTATGGCTACACCTTC	CASSPPGTGWKDYGYTF	TRBV18	TRBJ1-2
TGTGCTGGGGGCGAATGGAAAGACTATGGCTACACCTTC	CAGGEWKDYGYTF	TRBV5-4	TRBJ1-2
TGTGCCACCAGTGATTGCTGCAGGGTTTGGAAGGACTATGGCTACACCTTC	CATSDCCRVWKDYGYTF	TRBV24-1	TRBJ1-2
TGCAGTGCTTTCCTTCGATGGAAAGACTACGAGCAGTACTTC	CSAFLRWKDYEQYF	TRBV20-1	TRBJ2-7
TGTGCCAGCAGAAATGGGGCTTCTAGCTGGAAGGACTACGAGCAGTACTTC	CASRNGASSWKDYEQYF	TRBV11-2	TRBJ2-7
TGTGCCTGGAAGGACTACCCTATGACCACCTACAATGAGCAGTTCTTC	CAWKDYPMTTYNEQFF	TRBV30	TRBJ2-1
TGTGCCACCAGCAGTGTCCCCGCCGGGGCTTGGAAAGACTATGGCTACACCTTC	CATSSVPAGAWKDYGYTF	TRBV15	TRBJ1-2
TGTGCCTGGAAGGACTACCAACGCAATCAGCCCCAGCATTTT	CAWKDYQRNQPQHF	TRBV30	TRBJ1-5
TGTGCCAGCAGCTTAGTCACAGGGGGCGGACAGAGATGGAAGGACTACGAGCAGTACTTC	CASSLVTGGGQRWKDYEQYF	TRBV11-3	TRBJ2-7
TGTGCCAGCAGCTTAGTCGCAAGACAGGGGTGGAAGGACTACGAGCAGTACTTC	CASSLVARQGWKDYEQYF	TRBV11-3	TRBJ2-7
TGTGCCAGCAGTCCCGTAGGGGACTGGAAAGACTACGAGCAGTACTTC	CASSPVGDWKDYEQYF	TRBV6-1	TRBJ2-7
TGTGCCAGCTTGTGGAAAGACTATGGCTACACCTTC	CASLWKDYGYTF	TRBV2	TRBJ1-2
TGCAGCGATCAGTGGAAGGACTATGGCTACACCTTC	CSDQWKDYGYTF	TRBV29-1	TRBJ1-2
TGTGCCAGCTCACCACGGACAGGGTGGAAAGACTATGGCTACACCTTC	CASSPRTGWKDYGYTF	TRBV18	TRBJ1-2
TGTGCCAGCAGTTACATCTGGAAGGACTATAATTCACCCCTCCACTTT	CASSYIWKDYNSPLHF	TRBV6-5	TRBJ1-6
TGTGCCAGCAGTTGGAAGGACTATAACGAGCAGTACTTC	CASSWKDYNEQYF	TRBV27	TRBJ2-7
TGTGCCATCAGCTCGAAGGTAGAATGGAAAGACTACGTAACGGGGGTCGCTGAAGCTTTCTTT	CAISSKVEWKDYVTGVAEAFF	TRBV10-3	TRBJ1-1
TGTGCCAGCAGCCATATAGGGGGCTGGAAGGACTATGGCTACACCTTC	CASSHIGGWKDYGYTF	TRBV14	TRBJ1-2
TGTGCCAGCAGCAGTGACCGGGACAGGGCCATTTGGAAAGACTACGAGCAGTACTTC	CASSSDRDRAIWKDYEQYF	TRBV5-6	TRBJ2-7
TGTGCCAGCAGCCGGAGCCCCCTCCACTGGAAAGACTATGGCTACACCTTC	CASSRSPLHWKDYGYTF	TRBV9	TRBJ1-2
TGCAGCGTTAAAAGGGATTGGAAAGACTACGAGCAGTACTTC	CSVKRDWKDYEQYF	TRBV29-1	TRBJ2-7
TGTGCCAGCAGCCGCCGTATGGGAGGGTGGAAGGACTACGAGCAGTACTTC	CASSRRMGGWKDYEQYF	TRBV27	TRBJ2-7
TGTGCCAGCAGACCAGGGTGGAAGGACTATGGCTACACCTTC	CASRPGWKDYGYTF	TRBV7-4	TRBJ1-2
TGTGCTAGTGGTTGGAAAGACTATAGCAATCAGCCCCAGCATTTT	CASGWKDYSNQPQHF	TRBV12-5	TRBJ1-5
TGTGCCAGCCCGATTCGATACCGAGAAGTCTACGAGCAGTACTTC	CASPIRYREVYEQYF	TRBV11-2	TRBJ2-7
TGTGCCAGCAGTCCCTATAGGGAGGTTTATGAGCAGTTCTTC	CASSPYREVYEQFF	TRBV12-4	TRBJ2-1
TGTGCCAGCAGCTACAGGGAAGTAAGGGTTTTCTACGAGCAGTACTTC	CASSYREVRVFYEQYF	TRBV5-6	TRBJ2-7
TGTGCCAGCAGTGATGGCTACAGGGAAGTTGAAAAACTGTTTTTT	CASSDGYREVEKLFF	TRBV25-1	TRBJ1-4
TGTGCCAGCATCTACAGGGAAGTTAGTACAGATACGCAGTATTTT	CASIYREVSTDTQYF	TRBV27	TRBJ2-3
TGTGCCAGCAGTGAATACAGGGAGGTGGGAGCCAAAAACATTCAGTACTTC	CASSEYREVGAKNIQYF	TRBV25-1	TRBJ2-4
TGCGCCAGCACCCCCTCGCCGGGACGATACCGGGAAGTCTCCTACAATGAGCAGTTCTTC	CASTPSPGRYREVSYNEQFF	TRBV10-1	TRBJ2-1
TGCAGCGTTTACCGGGAGGTGATCTTC	CSVYREVIF	TRBV29-1	TRBJ2-1
TGTGCCACCAGTGATTACCGGGAGGTATGGAACATTCAGTACTTC	CATSDYREVWNIQYF	TRBV24-1	TRBJ2-4
TGTGCCAGCAGCCAAGGATACAGGGAGGTGGGCTACGAGCAGTACTTC	CASSQGYREVGYEQYF	TRBV3-1	TRBJ2-7
TGCGCCAGCAGTGAGTATCTCGTACCGGTCTACAGGGAGGTGTATCCTAATTCACCCCTCCACTTT	CASSEYLVPVYREVYPNSPLHF	TRBV10-1	TRBJ1-6
TGTGCCAGCTGGTACAGGGAGGTCTACGAGCAGTACTTC	CASWYREVYEQYF	TRBV28	TRBJ2-7
TGCGCCAGCAGCTTGGCTTATCGCGAGGTGTTAACTAATGAAAAACTGTTTTTT	CASSLAYREVLTNEKLFF	TRBV5-1	TRBJ1-4
TGCGCCAGCAGTGAGTATTACAGGGAAGTCTCGCGGGCGGGCACAGATACGCAGTATTTT	CASSEYYREVSRAGTDTQYF	TRBV10-1	TRBJ2-3
TGTGCCAGTAGTGGTCTGAGAATGCCCTACAGGGAGGTTTGGAGTCTGCGCGGCTCTGGGGCCAACGTCCTGACTTTC	CASSGLRMPYREVWSLRGSGANVLTF	TRBV19	TRBJ2-6
TGTGCCACCGGTTACAGGGAAGTTAATGAAAAACTGTTTTTT	CATGYREVNEKLFF	TRBV24-1	TRBJ1-4
TGTGCCAGCAGCCGATACAGGGAGGTGGAGGGGCTGAACTATGGCTACACCTTC	CASSRYREVEGLNYGYTF	TRBV11-2	TRBJ1-2
TGTGCCACCCCTTACAGGGAGGTCACCTACGAGCAGTACTTC	CATPYREVTYEQYF	TRBV24-1	TRBJ2-7
TGTGCCAGCAGTGAATATTACAGGGAGGTTAATGAAAAACTGTTTTTT	CASSEYYREVNEKLFF	TRBV25-1	TRBJ1-4
TGTGCCAGCAGTTACTATCGGGAGGTAATCACAGATACGCAGTATTTT	CASSYYREVITDTQYF	TRBV6-2	TRBJ2-3
TGTGCCAGCAGCTACAGGGAGGTCTGCAATTACGAGCAGTACTTC	CASSYREVCNYEQYF	TRBV5-4	TRBJ2-7
TGTGCCAGCAGCCGCCGTTGTCGATACAGGGAGGTTGGAAACACCATATATTTT	CASSRRCRYREVGNTIYF	TRBV11-3	TRBJ1-3
TGTGCCCTGCTATACAGGGAAGTCTATGGCTACACCTTC	CALLYREVYGYTF	TRBV11-3	TRBJ1-2
TGTGCCAGCTACCGGGAGGTGGAGGAAGAGGACAATCAGCCCCAGCATTTT	CASYREVEEEDNQPQHF	TRBV28	TRBJ1-5
TGTGCCAGCTACCGGGAGGTTAACGAGCAGTACTTC	CASYREVNEQYF	TRBV7-9	TRBJ2-7
TGTGCCACCACCTATAGGGAGGTGGAAACTAGCACAGATACGCAGTATTTT	CATTYREVETSTDTQYF	TRBV24-1	TRBJ2-3
TGTGCCAGCGCTTATCGGGACAGGTACCGGGAGGTGCTGGAAAAACTGTTTTTT	CASAYRDRYREVLEKLFF	TRBV6-1	TRBJ1-4
TGTGCCAGCAGCTTAGAATACCGGGAGGTGGGGTATCAGCCCCAGCATTTT	CASSLEYREVGYQPQHF	TRBV7-2	TRBJ1-5
TGTGCCAGCAGTTACAGGGAAGTTACAGTTCGGGGATACAATGAGCAGTTCTTC	CASSYREVTVRGYNEQFF	TRBV6-3	TRBJ2-1
TGTGCCAGCAGCTTAAGAGCCCCCTCTAGCGGGGGTGGATATAGGGAGGTCAATGAGCAGTTCTTC	CASSLRAPSSGGGYREVNEQFF	TRBV7-2	TRBJ2-1
TGTGCCAGCACCGGGTACCGGGAGGTTAGCTCCTACGAGCAGTACTTC	CASTGYREVSSYEQYF	TRBV6-5	TRBJ2-7
TGTGCCAGCAGCCACTACCGGGAGGTTACGGGCTCTGGGGCCAACGTCCTGACTTTC	CASSHYREVTGSGANVLTF	TRBV3-1	TRBJ2-6
TGTGCCAGCAGCCCTTACAGGGAGGTGTTACAGACCCAGTACTTC	CASSPYREVLQTQYF	TRBV3-1	TRBJ2-5
TGTGCCAGCAGAATTTACAGGGAGGTCGGCGGCACAGATACGCAGTATTTT	CASRIYREVGGTDTQYF	TRBV6-5	TRBJ2-3
TGTGCCAGCAGGAATTACAGGGAGGTCACTAACTATGGCTACACCTTC	CASRNYREVTNYGYTF	TRBV6-2	TRBJ1-2
TGTGCCAGCAGCTACAGGGAGGTACACCACACCATATATTTT	CASSYREVHHTIYF	TRBV11-2	TRBJ1-3
TGTGCCAGGGTAAAGCTCTACAGGGAGGTAGATACGCAGTATTTT	CARVKLYREVDTQYF	TRBV6-1	TRBJ2-3
TGTGCCAGCAGTTGTATCCCCTGTTACCGGGAAGTGAACACTGAAGCTTTCTTT	CASSCIPCYREVNTEAFF	TRBV6-3	TRBJ1-1
TGCGCCAGCAGCCGGGAATACAGGGAGGTTTATTTT	CASSREYREVYF	TRBV5-1	TRBJ1-3
TGTGCCATCACAAACCTATACAGGGAGGTCTATGGCTACACCTTC	CAITNLYREVYGYTF	TRBV27	TRBJ1-2
TGCGCCAGCAGCTTGCGTTTATACAGGGAAGTTCGTACCGGGGAGCTGTTTTTT	CASSLRLYREVRTGELFF	TRBV5-1	TRBJ2-2
TGCGCCAGCAGCTTGGGATACAGGGAAGTGTATGGCTACACCTTC	CASSLGYREVYGYTF	TRBV5-1	TRBJ1-2
TGTGCCAGCAGTTCGTACAGGGAGGTCACTGAAGCTTTCTTT	CASSSYREVTEAFF	TRBV27	TRBJ1-1
TGTGCTAGTGGTGTCTTTCCTCCAAGTTACAGGGAAGTAAACAATGAGCAGTTCTTC	CASGVFPPSYREVNNEQFF	TRBV12-5	TRBJ2-1
TGTGCCAGTAGTATAGACTTTCGGTACAGGGAAGTGATCTACAATGAGCAGTTCTTC	CASSIDFRYREVIYNEQFF	TRBV19	TRBJ2-1
TGTGCCAGCAGTTACAGGGAGGTACTGCTAGGCTACTACGAGCAGTACTTC	CASSYREVLLGYYEQYF	TRBV6-5	TRBJ2-7
TGTGCCAGCAGCTTTTACAGGGAAGTAAGTAGCAATCAGCCCCAGCATTTT	CASSFYREVSSNQPQHF	TRBV11-3	TRBJ1-5
TGTGCCTGTGCCCGTTCCGCCTACAGGGAGGTGAGGGTTAAGGACTATGGCTACACCTTC	CACARSAYREVRVKDYGYTF	TRBV30	TRBJ1-2
TGTGCCAGCTCACCATGTTATAGAGAAGTTTTGTTCAGAGGAAAGTCGAACACCGGGGAGCTGTTTTTT	CASSPCYREVLFRGKSNTGELFF	TRBV18	TRBJ2-2
TGTGCCAGCAGCTTAGTTTTTTACCGAGAGGTGACCTACAATGAGCAGTTCTTC	CASSLVFYREVTYNEQFF	TRBV7-9	TRBJ2-1
TGTTATAGGGAAGTCAGGACAGATACGCAGTATTTT	CYREVRTDTQYF	TRBV6-5	TRBJ2-3
TGCAGTGCTAGAGTGTACAGGGAGGTCCCTAGTACCTACGAGCAGTACTTC	CSARVYREVPSTYEQYF	TRBV20-1	TRBJ2-7
TGTGCCAGCAGCTTATATCGGGAGGTGACGCTGAACACTGAAGCTTTCTTT	CASSLYREVTLNTEAFF	TRBV7-6	TRBJ1-1
TGTGCCAGCAGCGGCCTGGGAGGGTACAGGGAGGTTACTACCTCCTACGAGCAGTACTTC	CASSGLGGYREVTTSYEQYF	TRBV7-4	TRBJ2-7
TGTGCCAGCAGCAGATACAGGGAGGTATGGTGCTCCTACAATGAGCAGTTCTTC	CASSRYREVWCSYNEQFF	TRBV6-5	TRBJ2-1
TGTGCCAGCAGTCCCTACAGGGAGGTTTTTTGGCGGTACGAGCAGTACTTC	CASSPYREVFWRYEQYF	TRBV27	TRBJ2-7
TGTGCCAGCAGCTTAGTTTCTCTCCGCTACAGGGAAGTAAGGGGAAACACCATATATTTT	CASSLVSLRYREVRGNTIYF	TRBV7-9	TRBJ1-3
TGCAGTGCTACTGGCTATCGTGAGGTAGACGCGAACACCGGGGAGCTGTTTTTT	CSATGYREVDANTGELFF	TRBV20-1	TRBJ2-2
TGTGCCACCTCGTACAGGGAAGTCTACTACGAGCAGTACTTC	CATSYREVYYEQYF	TRBV10-3	TRBJ2-7
TGCAGTGCTATTTACCGGGAGGTATACGAGCAGTACTTC	CSAIYREVYEQYF	TRBV20-1	TRBJ2-7
TGCAGCTACCGGGAGGTCAATGAAAAACTGTTTTTT	CSYREVNEKLFF	TRBV29-1	TRBJ1-4
TGTGCCAGCAGCTTTAGGTACAGGGAAGTACTTTACACAGATACGCAGTATTTT	CASSFRYREVLYTDTQYF	TRBV5-4	TRBJ2-3
TGTGCCAGCAGTTACCGGGAGGTCGGACAGACACTCAAAAACATTCAGTACTTC	CASSYREVGQTLKNIQYF	TRBV6-5	TRBJ2-4
TGCGCCAGCAGTGCCGGAGATTACAGGGAGGTATCGCGAGAGACCCAGTACTTC	CASSAGDYREVSRETQYF	TRBV10-1	TRBJ2-5
TGTGCCAGCAGTTTGGTCCCTTCGTATAGGGAGGTCTACGAGCAGTACTTC	CASSLVPSYREVYEQYF	TRBV12-3	TRBJ2-7
TGTGCCACCATGTACCGCGAGGTCAATCAGCCCCAGCATTTT	CATMYREVNQPQHF	TRBV15	TRBJ1-5
TGCGCCAGCAGCCATTATCGGGAGGTTCAAGAGACCCAGTACTTC	CASSHYREVQETQYF	TRBV4-3	TRBJ2-5
TGTGCCAGCAGTTACCGGGAGGTATATCAGCCCCAGCATTTT	CASSYREVYQPQHF	TRBV6-2	TRBJ1-5
TGTGCCAGCAGTATCTTGTACAGGGAAGTGGGGGATGGGGCCAACGTCCTGACTTTC	CASSILYREVGDGANVLTF	TRBV27	TRBJ2-6
TGTGCCAGTAGTATCAATTACAGGGAGGTAGAGACCCAGTACTTC	CASSINYREVETQYF	TRBV19	TRBJ2-5
TGTGCCAGCAGCTCACACCCCTACAGGGAGGTTCAGCCCCAGCATTTT	CASSSHPYREVQPQHF	TRBV11-1	TRBJ1-5
TGCAGCGTTGAAGATTACAGGGAAGTAACGCGCAATCAGCCCCAGCATTTT	CSVEDYREVTRNQPQHF	TRBV29-1	TRBJ1-5
TGTGCCAGCAGCATCCGGGACTACCGAGAAGTCGGGGAGCTGTTTTTT	CASSIRDYREVGELFF	TRBV13	TRBJ2-2
TGTGCCAGCACCTACAGGGAAGTAGTGATCCAGTCGAACACTGAAGCTTTCTTT	CASTYREVVIQSNTEAFF	TRBV9	TRBJ1-1
TGTGCCACCAGTTACCGGGAAGTTTGCGAGAATGAGCAGTTCTTC	CATSYREVCENEQFF	TRBV24-1	TRBJ2-1
TGTGCACGGATTTACCGGGAGGTTACCGGGGAGCTGTTTTTT	CARIYREVTGELFF	TRBV11-3	TRBJ2-2
TGCGCCAGCAGCAGGGGGGACAGATATCGGGAGGTCCGGTGTGAAAAACTGTTTTTT	CASSRGDRYREVRCEKLFF	TRBV5-1	TRBJ1-4
TGTGCCATCAGTGAGTACAGGGAGGTTTCTATAGAGCAGTTCTTC	CAISEYREVSIEQFF	TRBV10-3	TRBJ2-1
TGTGCCAAAGAGTACAGGGAGGTCGACAATGAGCAGTTCTTC	CAKEYREVDNEQFF	TRBV25-1	TRBJ2-1
TGTGCCACCAGTGATTTATACCGGGAGGTCAGAATGACCTACAATGAGCAGTTCTTC	CATSDLYREVRMTYNEQFF	TRBV24-1	TRBJ2-1
TGTGCCAGCAGCTTAGATCGATACAGGGAAGTCCCAACAGATACGCAGTATTTT	CASSLDRYREVPTDTQYF	TRBV11-3	TRBJ2-3
TGTGCCAGCAGCCAGTACAGGGAGGTTGGGATCGAGGCGAGCTACACCTTC	CASSQYREVGIEASYTF	TRBV7-9	TRBJ1-2
TGTGCCAGCAGCTACCGGGAGGTTGGACAGCAGGCTGGGGCCAACGTCCTGACTTTC	CASSYREVGQQAGANVLTF	TRBV5-4	TRBJ2-6
TGTGCCAGCAGTGATCCACCGGCTAGCTACAGGGAAGTGGATGGCTACACCTTC	CASSDPPASYREVDGYTF	TRBV2	TRBJ1-2
TGTGCCACCAGTGATTGCTACAGGGAAGTCAACTATGGCTACACCTTC	CATSDCYREVNYGYTF	TRBV24-1	TRBJ1-2
TGTGCCAGCAGTATGAATATGTACAGGGAGGTCAATCAGCCCCAGCATTTT	CASSMNMYREVNQPQHF	TRBV6-1	TRBJ1-5
TGTGCCAGCAGTTACTACAGGGAGGTTCGGAACACTGAAGCTTTCTTT	CASSYYREVRNTEAFF	TRBV6-5	TRBJ1-1
TGTGCCACCTATCGGGAGGTATTTACCTACAATGAGCAGTTCTTC	CATYREVFTYNEQFF	TRBV19	TRBJ2-1
TGTGCCAGCAGTTACCGAGAGGTTCGGGACAGGAGGGACAATCAGCCCCAGCATTTT	CASSYREVRDRRDNQPQHF	TRBV6-3	TRBJ1-5
TGTGCCAGCAGTTATAGGGAGGTCAGGAGGAACACCGGGGAGCTGTTTTTT	CASSYREVRRNTGELFF	TRBV6-5	TRBJ2-2
TGCGCCAGCAGCTTGGTCGGGGATCGGATTTACCGAGAGGTCACAGATACGCAGTATTTT	CASSLVGDRIYREVTDTQYF	TRBV5-1	TRBJ2-3
TGTGCCAGCAGCTACCGGGAGGTTGCTATCTCCTATAATTCACCCCTCCACTTT	CASSYREVAISYNSPLHF	TRBV13	TRBJ1-6
TGTGCCACCAGTATATACCGGGAGGTTGAAAACACAGATACGCAGTATTTT	CATSIYREVENTDTQYF	TRBV24-1	TRBJ2-3
TGTGCCTGGTACAGGGAGGTGGCCAACGTCCTGACTTTC	CAWYREVANVLTF	TRBV30	TRBJ2-6
TGTGCCAGCAGTTTATATAGGGAGGTACGGATAGATGGCTACACCTTC	CASSLYREVRIDGYTF	TRBV27	TRBJ1-2
TGTGCCAGCATGTATCGGGAGGTCTACAATGAGCAGTTCTTC	CASMYREVYNEQFF	TRBV27	TRBJ2-1
TGTGCCAGCAGCCAAGACTATAGGGAGGTCGATGTGAACACTGAAGCTTTCTTT	CASSQDYREVDVNTEAFF	TRBV14	TRBJ1-1
TGTGCCAGTAGTATAGCGCCGGGCTACAGGGAGGTGTCCCGAGAGACCCAGTACTTC	CASSIAPGYREVSRETQYF	TRBV19	TRBJ2-5
TGTGCCAGCAGCTACAGGGAGGTAATAAACGAGCAGTACTTC	CASSYREVINEQYF	TRBV7-3	TRBJ2-7
TGTGCCATCAGTGAGTCGTACAGGGAGGTAGGGGTGAACACTGAAGCTTTCTTT	CAISESYREVGVNTEAFF	TRBV10-3	TRBJ1-1
TGTGCCAGCAGCTATAGGGAGGTAAACACCGGGGAGCTGTTTTTT	CASSYREVNTGELFF	TRBV7-9	TRBJ2-2
TGTGCCTGGGTCTACCGGGAGGTAACCAATAGCTCTGGAAACACCATATATTTT	CAWVYREVTNSSGNTIYF	TRBV30	TRBJ1-3
TGTGCCAGCAGCTACCCCCCTTACAGGGAAGTCACAGATACGCAGTATTTT	CASSYPPYREVTDTQYF	TRBV7-3	TRBJ2-3
TGTGCCAGCCCCAAACCCCCCCTAACGTACAGGGAGGTGATTCAGTACTTC	CASPKPPLTYREVIQYF	TRBV7-9	TRBJ2-4
TGTGCCACCAGCAGAGAACATTACAGGGAAGTCTACGAGCAGTACTTC	CATSREHYREVYEQYF	TRBV15	TRBJ2-7
TGTGCCAGCAGTCCCTACAGGGAGGTTACCCCTTCCTATAATTCACCCCTCCACTTT	CASSPYREVTPSYNSPLHF	TRBV27	TRBJ1-6
TGTGCCAGCAGTAGATACAGGGAAGTCGAGGATGAGCAGTTCTTC	CASSRYREVEDEQFF	TRBV12-4	TRBJ2-1
TGCGCCAGCTACAGGGAAGTTAGCTACGAGCAGTACTTC	CASYREVSYEQYF	TRBV10-1	TRBJ2-7
TGTGCCAGCAGCTTAAGTTACAGGGAGGTCAATCAGCCCCAGCATTTT	CASSLSYREVNQPQHF	TRBV7-9	TRBJ1-5
TGTGCCAGCAGCTTAGATTCAACATACAGGGAAGTCGCTGAAGCTTTCTTT	CASSLDSTYREVAEAFF	TRBV11-3	TRBJ1-1
TGTGCCAGCAGCTTAGTTTACAGGGAAGTATCTGAAGCTTTCTTT	CASSLVYREVSEAFF	TRBV7-7	TRBJ1-1
TGTGCCAGCAGAACATACCGTGAGGTGCAGTTCTTC	CASRTYREVQFF	TRBV6-5	TRBJ2-1
TGTGCCACCAGTGACTACCGCGAGGTGTTAAGGGACACTGAAGCTTTCTTT	CATSDYREVLRDTEAFF	TRBV24-1	TRBJ1-1
TGTGCCAGCAGCGTAGACAGTTACAGGGAAGTGGGGAGCGAGCAGTACTTC	CASSVDSYREVGSEQYF	TRBV9	TRBJ2-7
TGCGCCAGCAGCTTGATCTACAGGGAGGTAAAACTGTTTTTT	CASSLIYREVKLFF	TRBV5-1	TRBJ1-4
TGTGCCAGCAGCTTAAACTACAGGGAGGTAGCCTACGAGCAGTACTTC	CASSLNYREVAYEQYF	TRBV7-3	TRBJ2-7
TGCGCCAGCAGCCAAGGGAGGTACAGGGAGGTTGAAGCTTTCTTT	CASSQGRYREVEAFF	TRBV4-1	TRBJ1-1
TGTGCCAGCAGTTCGTACCGGGAGGTCGAGACCCAGTACTTC	CASSSYREVETQYF	TRBV12-3	TRBJ2-5
TGTGCCAGCAGGCCAATTTACAGGGAGGTGCCCCAGCATTTT	CASRPIYREVPQHF	TRBV27	TRBJ1-5
TGTGCCAGCAGCCCCTATAGGGAGGTAATTGATTCACCCCTCCACTTT	CASSPYREVIDSPLHF	TRBV3-1	TRBJ1-6
TGCAGTGCTTATAGGGAGGTGGGACATAGCTCCTACAATGAGCAGTTCTTC	CSAYREVGHSSYNEQFF	TRBV20-1	TRBJ2-1
TGTGCCAGCAGTGATTACAGGGAGGTGAACACTGAAGCTTTCTTT	CASSDYREVNTEAFF	TRBV25-1	TRBJ1-1
TGTGCCAGCAGCGCATGGTACAGGGAAGTAGAGACCCAGTACTTC	CASSAWYREVETQYF	TRBV6-5	TRBJ2-5
TGTGCCAGCAGTGACTCGATGGATTACAGGGAGGTTGATCAGCCCCAGCATTTT	CASSDSMDYREVDQPQHF	TRBV6-4	TRBJ1-5
TGTGCCAGCAGCTACAGGGAGGTCCCAGATTATGGCTACACCTTC	CASSYREVPDYGYTF	TRBV5-4	TRBJ1-2
TGTGCCAGCAGTTATCGGGAGGTGCCGACTGAAAAACTGTTTTTT	CASSYREVPTEKLFF	TRBV6-5	TRBJ1-4
TGTGCCAATTACAGGGAAGTGAGCGATACGCAGTATTTT	CANYREVSDTQYF	TRBV19	TRBJ2-3
TGTGCCAGCAGGCGCGTGGAAGAGTATAGAGAAGTTCCTAGCACAGATACGCAGTATTTT	CASRRVEEYREVPSTDTQYF	TRBV13	TRBJ2-3
TGTGCCCTCTACAGAGAGGTCACCGGGGAGCTGTTTTTT	CALYREVTGELFF	TRBV11-2	TRBJ2-2
TGTGCCAGCAGTGTAGGGGACAGGGGCTATCGCGAAGTCGAGCAGTACTTC	CASSVGDRGYREVEQYF	TRBV6-3	TRBJ2-7
TGTGCCAGTAGTATAGCATTTCCTTACAGGGAAGTGCCCCAGCATTTT	CASSIAFPYREVPQHF	TRBV19	TRBJ1-5
TGTGCCAGTAGTACCCCCTACAGGGAGGTTACAGATACGCAGTATTTT	CASSTPYREVTDTQYF	TRBV19	TRBJ2-3
TGTGCCAGCAGAATAGGCTACAGGGAAGTAGCTTTCTTT	CASRIGYREVAFF	TRBV6-3	TRBJ1-1
TGTGCCAGCTCCTATTGGTTCCGGTACAGGGAGGTAACACCCTACGAGCAGTACTTC	CASSYWFRYREVTPYEQYF	TRBV6-3	TRBJ2-7
TGTGCCAGTAGTATAGATAAGGGATACAGGGAAGTGGACACCGGGGAGCTGTTTTTT	CASSIDKGYREVDTGELFF	TRBV19	TRBJ2-2
TGTGCCAGCAGTTACCGGGAGGTATTCAAGGTCGCCTACGAGCAGTACTTC	CASSYREVFKVAYEQYF	TRBV6-5	TRBJ2-7
TGTGCCAGCAGCGGATATCGGGAGGTGCCCCAGCATTTT	CASSGYREVPQHF	TRBV7-4	TRBJ1-5
TGTGCCAGCTTATACAGGGAAGTTCAGCCCCAGCATTTT	CASLYREVQPQHF	TRBV6-6	TRBJ1-5
TGTGCCAGCAGTGAATACCGGGAGGTCCCCGGAGGCTACACCTTC	CASSEYREVPGGYTF	TRBV2	TRBJ1-2
TGTGCCAGCAGCTTAGTTACTTACCGGGAGGTCTATGGCTACACCTTC	CASSLVTYREVYGYTF	TRBV7-2	TRBJ1-2
TGTGCCAGCTTGGTTCTAGCGGGCCCTTACAGGGAGGTCAATGAGCAGTTCTTC	CASLVLAGPYREVNEQFF	TRBV7-3	TRBJ2-1
TGTGCCAGCAGCTATCGCGAAGTTCGCTACAATGAGCAGTTCTTC	CASSYREVRYNEQFF	TRBV13	TRBJ2-1
TGTGCCAGCGATATACCCCAATACAGGGAGGTCTATGGCTACACCTTC	CASDIPQYREVYGYTF	TRBV6-4	TRBJ1-2
TGCGCCAGCAGCCGAACCACCTACAGGGAGGTCACCGGGGAGCTGTTTTTT	CASSRTTYREVTGELFF	TRBV4-1	TRBJ2-2
TGTGCCACCAGCAGAGATTACCATTACAGGGAAGTGTTGTCCTACGAGCAGTACTTC	CATSRDYHYREVLSYEQYF	TRBV15	TRBJ2-7
TGCAGTGCCGGAGGGTATAGAGAGGTTAAAGAGCAGTTCTTC	CSAGGYREVKEQFF	TRBV20-1	TRBJ2-1
TGTGCCAGCAGCCCCTATAGGGAGGTCGAGAGATTTAATGAGCAGTTCTTC	CASSPYREVERFNEQFF	TRBV7-9	TRBJ2-1
TGTGCCAGCATTTACAGGGAGGTATTAGAGACCCAGTACTTC	CASIYREVLETQYF	TRBV7-3	TRBJ2-5
TGCGCCAGCAGTCAGAATTACCGGGAAGTTCGGCCGAGCTCCTACAATGAGCAGTTCTTC	CASSQNYREVRPSSYNEQFF	TRBV10-1	TRBJ2-1
TGTGCCAGCAGCCCCTACAGGGAGGTGCCAATCAATGAGCAGTTCTTC	CASSPYREVPINEQFF	TRBV7-3	TRBJ2-1
TGTGCCAGCAGTTCCTACAGGGAGGTTACAGATACGCAGTATTTT	CASSSYREVTDTQYF	TRBV27	TRBJ2-3
TGTGCCAGCAGCTTGGGATACCGCGAAGTGAGGAGCTACGAGCAGTACTTC	CASSLGYREVRSYEQYF	TRBV5-8	TRBJ2-7
TGTGCCAGCAGTTACAAGGGCTACAGGGAAGTACCCTATGGCTACACCTTC	CASSYKGYREVPYGYTF	TRBV6-5	TRBJ1-2
TGTGCCTGGACCTACAGGGAGGTTTTCTATGGCTACACCTTC	CAWTYREVFYGYTF	TRBV30	TRBJ1-2
TGTGCCAGCAGTTACAGGGAGGTTTGGGGCTACGAGCAGTACTTC	CASSYREVWGYEQYF	TRBV6-2	TRBJ2-7
TGTGCCAGCAGCCACCCACTCTATCGGGAGGTCACCGGGGAGCTGTTTTTT	CASSHPLYREVTGELFF	TRBV7-3	TRBJ2-2
TGTGCCAGCAGTTACAGGGAGGTGACTCATTTAACCTATAGCAATCAGCCCCAGCATTTT	CASSYREVTHLTYSNQPQHF	TRBV6-6	TRBJ1-5
TGTGCCAGCAGCTGTTACAGGGAAGTCGAGCAGTACTTC	CASSCYREVEQYF	TRBV7-6	TRBJ2-7
TGTGCCAGCAGCTCGGGACAGGGGGCATACCGCGAGGTCGCCTTC	CASSSGQGAYREVAF	TRBV7-9	TRBJ1-2
TGCGCCAGCAGCCAAGCCGGGTACAGGGAGGTCACCGGGGAGCTGTTTTTT	CASSQAGYREVTGELFF	TRBV4-1	TRBJ2-2
TGTGCCAGCAGTGTGACGTACAGGGAAGTTCAAGGGCACTACAATGAGCAGTTCTTC	CASSVTYREVQGHYNEQFF	TRBV2	TRBJ2-1
TGTGCCAGCAGTTGGTACAGGGAGGTTGAAAAACTGTTTTTT	CASSWYREVEKLFF	TRBV6-1	TRBJ1-4
TGCGCCAGCAGCCCGGGGGATTACAGGGAGGTTCACAATGAGCAGTTCTTC	CASSPGDYREVHNEQFF	TRBV5-1	TRBJ2-1
TGTGCCAGCAGCGGGTATCGGGAAGTCTACAATGAGCAGTTCTTC	CASSGYREVYNEQFF	TRBV5-6	TRBJ2-1
TGTGCCAGCAGCAAGTACAGGGAAGTGTGCGAGCAGTACTTC	CASSKYREVCEQYF	TRBV9	TRBJ2-7
TGCAGTGCTTACAGGGAGGTGAACACTGAAGCTTTCTTT	CSAYREVNTEAFF	TRBV20-1	TRBJ1-1
TGTGCCTGGAGTTACAGGGAGGTATGTAAGAGAAACACCTTC	CAWSYREVCKRNTF	TRBV30	TRBJ1-2
TGTGCCAGCAGCCTATACAGGGAAGTCCCCGAAGAGACCCAGTACTTC	CASSLYREVPEETQYF	TRBV7-3	TRBJ2-5
TGTGCCAGCAGCAAACATTATCGGGAGGTTTCGCAGTATTTT	CASSKHYREVSQYF	TRBV7-2	TRBJ2-3
TGTGCCAGCAGCTACAGGGAAGTTAGTCTGGAGACAAATAGGTCACCCCTCCACTTT	CASSYREVSLETNRSPLHF	TRBV5-4	TRBJ1-6
TGTGCCAGCAGCTTATACAGGGAAGTGGCCTACCAAGAGACCCAGTACTTC	CASSLYREVAYQETQYF	TRBV7-7	TRBJ2-5
TGTGCCAAAGTTTACAGGGAGGTCTCCTACGAGCAGTACTTC	CAKVYREVSYEQYF	TRBV7-9	TRBJ2-7
TGTGCCAGCAGCATGATCTACAGGGAAGTCTACGAGCAGTACTTC	CASSMIYREVYEQYF	TRBV7-3	TRBJ2-7
TGCAGTGCTAGACCCTACAGGGAGGTTTTCCGCCCCTATGGCTACACCTTC	CSARPYREVFRPYGYTF	TRBV20-1	TRBJ1-2
TGTGCCAGCAGGTATCGGGAGGTAACCTACACCTTC	CASRYREVTYTF	TRBV2	TRBJ1-2
TGTGCCAGCAGTTACCGGGAGGTCCCGGGCAGCACAGATACGCAGTATTTT	CASSYREVPGSTDTQYF	TRBV6-5	TRBJ2-3
TGTGCCAGCAGCTCGTACAGGGAGGTTTATAATTCACCCCTCCACTTT	CASSSYREVYNSPLHF	TRBV7-9	TRBJ1-6
TGTGCCTACAGGGAAGTAGACGAGCAGTACTTC	CAYREVDEQYF	TRBV27	TRBJ2-7
TGTGCCAGCAGTTACAGGGAGGTGCAAGAGACCCAGTACTTC	CASSYREVQETQYF	TRBV6-3	TRBJ2-5
TGCGCCAGCAGCTTGCCTTTGTTCGAATACAGGGAGGTCGGCTACGAGCAGTACTTC	CASSLPLFEYREVGYEQYF	TRBV5-1	TRBJ2-7
TGTGCTAGTGGTTTCTACCGGGAGGTCTTC	CASGFYREVF	TRBV12-5	TRBJ2-1
TGCAGCGAAATATCTTACAGGGAAGTTAATGAAAAACTGTTTTTT	CSEISYREVNEKLFF	TRBV29-1	TRBJ1-4
TGTGCCAGCAGGTATCGGGAGGTATGCAGGGTTCGAAGGATTCAGCCCCAGCATTTT	CASRYREVCRVRRIQPQHF	TRBV27	TRBJ1-5
TGTGCCAGCAGCTGGGCTTACAGGGAGGTCAAGAATGGCTACACCTTC	CASSWAYREVKNGYTF	TRBV13	TRBJ1-2
TGTGCCAGCAGTGGCTACAGGGAAGTGAACTCCTACGAGCAGTACTTC	CASSGYREVNSYEQYF	TRBV6-1	TRBJ2-7
TGTGCCAGCTACAGGGAGGTTGGCTACACCTTC	CASYREVGYTF	TRBV28	TRBJ1-2
TGTGCCATCTACCGGGAGGTAACAGATACGCAGTATTTT	CAIYREVTDTQYF	TRBV10-3	TRBJ2-3
TGTGCCACCGCCTATCGCGAGGTAGGACAGGGAGCTAATCAGCCCCAGCATTTT	CATAYREVGQGANQPQHF	TRBV24-1	TRBJ1-5
TGTGCCTGGAGCTACAGGGAAGTAGGTAACACCATATATTTT	CAWSYREVGNTIYF	TRBV30	TRBJ1-3
TGTGCCAGCAGTTACCGCGAGGTGACTAGCGGAAAGTCCTACGAGCAGTACTTC	CASSYREVTSGKSYEQYF	TRBV6-5	TRBJ2-7
TGTGCCAGCAGCTTTTACCGGGAAGTTATGGCCCGGACCCATCAGCCCCAGCATTTT	CASSFYREVMARTHQPQHF	TRBV7-6	TRBJ1-5
TGTGCTAGTGGTTACCGGGAGGTCGAGCAGTACTTC	CASGYREVEQYF	TRBV12-5	TRBJ2-7
TGTGCCAGCAGCAAGCGGTACAGGGAAGTTGAAAAACTGTTTTTT	CASSKRYREVEKLFF	TRBV11-2	TRBJ1-4
TGTGCCAGCAGTTACCATGATTACAGGGAGGTGTGTTGCCACACCATATATTTT	CASSYHDYREVCCHTIYF	TRBV12-3	TRBJ1-3
TGTGCCAGCAGCTATCGGGAGGTTAGCCCTGAAGCTTTCTTT	CASSYREVSPEAFF	TRBV14	TRBJ1-1
TGTGCCAGCAGTTACCGGGAGGTACTCATGAACACTGAAGCTTTCTTT	CASSYREVLMNTEAFF	TRBV28	TRBJ1-1
TGCGCCAGCCATTACCGGGAGGTCAGGGTCGAGCAGTACTTC	CASHYREVRVEQYF	TRBV10-1	TRBJ2-7
TGTGCCAGCAGTTACTCGGTGTACCGGGAGGTCGCAGGAAGCACAGATACGCAGTATTTT	CASSYSVYREVAGSTDTQYF	TRBV6-3	TRBJ2-3
TGTGCCAGCAGCTCTTACAGGGAGGTTTTTGAGAGGGCCAAAAACATTCAGTACTTC	CASSSYREVFERAKNIQYF	TRBV11-3	TRBJ2-4
TGTGCCAGCAGTGATCCCTACAGGGAAGTCAGCAATCAGCCCCAGCATTTT	CASSDPYREVSNQPQHF	TRBV6-4	TRBJ1-5
TGTGCCACCAGTGAACGTTTCTACAATGAGCAGTTCTTC	CATSERFYNEQFF	TRBV24-1	TRBJ2-1
TGTGCCAGCAGCAGAGAACGCTTTTATCAGCCCCAGCATTTT	CASSRERFYQPQHF	TRBV6-4	TRBJ1-5
TGTGCCAGCAGCCAATCGGGGGGGGAAAGGTTCTACGAGCAGTACTTC	CASSQSGGERFYEQYF	TRBV3-1	TRBJ2-7
TGCAGCGAGCGGTTTTACAATCAGCCCCAGCATTTT	CSERFYNQPQHF	TRBV29-1	TRBJ1-5
TGTGCCACCGCCCTCCAGGGGGAGCGGTTCTACGAGCAGTACTTC	CATALQGERFYEQYF	TRBV24-1	TRBJ2-7
TGTGCCTGGAGTGTCCCGCCAGAGCGGTTTTACGAGCAGTACTTC	CAWSVPPERFYEQYF	TRBV30	TRBJ2-7
TGTGCCAGCAGACCCCCGCGGGAGCGGTTCTATGGCTACACCTTC	CASRPPRERFYGYTF	TRBV7-9	TRBJ1-2
TGTGCCAGCAGTTTATGGGAGCGGGAGAGATTCTACGAGCAGTACTTC	CASSLWERERFYEQYF	TRBV27	TRBJ2-7
TGTGCCAGCAGCTTGGACGAAAGATTCTATTTGCGAGGCTTGACCCAGTACTTC	CASSLDERFYLRGLTQYF	TRBV5-6	TRBJ2-5
TGTGCCAGCAGCCAAGATCCACTCGTGGAACGGTTTTACGAGCAGTACTTC	CASSQDPLVERFYEQYF	TRBV14	TRBJ2-7
TGCAGTGCTAGAGATACGCGGGAGAGGTTCTACGAGCAGTACTTC	CSARDTRERFYEQYF	TRBV20-1	TRBJ2-7
TGTGCCAGCTCCGAACGGTTCTACGAGCAGTACTTC	CASSERFYEQYF	TRBV5-6	TRBJ2-7
TGTGCCTGGAGTGTACCCCCCGGTCGGACAGAACGGTTCTACGAGCAGTACTTC	CAWSVPPGRTERFYEQYF	TRBV30	TRBJ2-7
TGTGCCAGCAGTTACGGGTTGGGGAGACAGGAAAGGTTCTACGAGCAGTACTTC	CASSYGLGRQERFYEQYF	TRBV6-2	TRBJ2-7
TGTGCTGGCGGGGGACCGACTGGAGAGAGGGAGCGCTTCTACAATGAGCAGTTCTTC	CAGGGPTGERERFYNEQFF	TRBV12-5	TRBJ2-1
TGCGCCAGCATTCCAACCGAGCGGTTTTACAATGAGCAGTTCTTC	CASIPTERFYNEQFF	TRBV10-1	TRBJ2-1
TGCAGTGGGGGGGCGGAACGATTCTACAATGAGCAGTTCTTC	CSGGAERFYNEQFF	TRBV20-1	TRBJ2-1
TGTGCCAGCAGTTTCAGCGGACAGGAGCGCTTCTATAGCAATCAGCCCCAGCATTTT	CASSFSGQERFYSNQPQHF	TRBV27	TRBJ1-5
TGTGCCAGCAGTTACTCCGAGAGGTTCTATTCACCCCTCCACTTT	CASSYSERFYSPLHF	TRBV6-6	TRBJ1-6
TGCAGTGCTAGAGACAGATATGAGCGTTTTTATTTT	CSARDRYERFYF	TRBV20-1	TRBJ2-3
TGTGCCAGCAGCCAAGCAGAACGATTCTATGGCTACACCTTC	CASSQAERFYGYTF	TRBV3-1	TRBJ1-2
TGCGCCAGCAGCCAAGCCACGGAACGGTTTTACCAAGAGACCCAGTACTTC	CASSQATERFYQETQYF	TRBV4-1	TRBJ2-5
TGTGCCAGCAGTTATTGGGCCGAAAGATTTTACGAGCAGTACTTC	CASSYWAERFYEQYF	TRBV6-5	TRBJ2-7
TGTGCCATCAGCGGGGCTAGCGTGGGGGGTGAGGAGAGATTCTACGAGCAGTACTTC	CAISGASVGGEERFYEQYF	TRBV10-3	TRBJ2-7
TGTGCCAGCAGCCGGACTAGCGGCGAAAGGTTTTACAATGAGCAGTTCTTC	CASSRTSGERFYNEQFF	TRBV3-1	TRBJ2-1
TGTGCCAGCAGTTACACAGTAGAGAGGTTCTACAATGAGCAGTTCTTC	CASSYTVERFYNEQFF	TRBV6-5	TRBJ2-1
TGCAGCGTTGATAGGGTAAGGGAAGAACGATTTTATGAGCAGTTCTTC	CSVDRVREERFYEQFF	TRBV29-1	TRBJ2-1
TGTGCCAGCAGTTACTCCGTCGGGGGGGAACGGTTCTACGAGCAGTACTTC	CASSYSVGGERFYEQYF	TRBV6-3	TRBJ2-7
TGTGCCAGCAGCCAAGAACGATTTTATAGCAATCAGCCCCAGCATTTT	CASSQERFYSNQPQHF	TRBV3-1	TRBJ1-5
TGTGCCAGCAGTGAAAGATTCTACCCGGCTCAGGGGACGAACACCGGGGAGCTGTTTTTT	CASSERFYPAQGTNTGELFF	TRBV6-1	TRBJ2-2
TGTGCCAGCAGCGAAGGGGACAGGGAAAGATTCTATGGCTACACCTTC	CASSEGDRERFYGYTF	TRBV3-1	TRBJ1-2
TGTGCCAGTAGGCATAGCGAGAGATTCTACAATGAGCAGTTCTTC	CASRHSERFYNEQFF	TRBV19	TRBJ2-1
TGTGCCAGCAGTTACTCTACTGGGACAGGGGAACGTTTTTACGAGCAGTACTTC	CASSYSTGTGERFYEQYF	TRBV6-5	TRBJ2-7
TGTGCCAGCAGCGAGCGGGGGTTGCGGGAGCGGTTTTACGAGCAGTACTTC	CASSERGLRERFYEQYF	TRBV11-2	TRBJ2-7
TGTGCCAGCAGCTCCAGGGACAGAGAACGTTTTTACTATGGCTACACCTTC	CASSSRDRERFYYGYTF	TRBV7-9	TRBJ1-2
TGTGAGCGGTTTTACACTGAAGCTTTCTTT	CERFYTEAFF	TRBV24-1	TRBJ1-1
TGTGCCAGCAGCCCTCCCCCCCCCCCAGAGAGGTTCTACGAGCAGTACTTC	CASSPPPPPERFYEQYF	TRBV13	TRBJ2-7
TGTGCCAGCAGCCAGGCCGGCCCCCCGGGCAGGGTGGAAAGATTCTACGAGCAGTACTTC	CASSQAGPPGRVERFYEQYF	TRBV7-9	TRBJ2-7
TGTGCCAGCAGCTTAGCCGAGAGGGAGCGGTTCTATGGCTACACCTTC	CASSLAERERFYGYTF	TRBV11-3	TRBJ1-2
TGTGCCAGCAGCGTACCCACTCAGGAGCGGTTCTACAATGAGCAGTTCTTC	CASSVPTQERFYNEQFF	TRBV5-6	TRBJ2-1
TGTGCCAGCAGGGACAGGGAGCGGTTCTACGCTGAAGCTTTCTTT	CASRDRERFYAEAFF	TRBV27	TRBJ1-1
TGTGCCAGCGTTCCCCAGGAACGCTTCTACGAGCAGTACTTC	CASVPQERFYEQYF	TRBV9	TRBJ2-7
TGTGCCAGCAGTTACTCTAGACAGGAGAGATTTTATGCCTACGAGCAGTACTTC	CASSYSRQERFYAYEQYF	TRBV6-5	TRBJ2-7
TGCGCCAGCAGCCGGCGGGACAGGGAAAGATTTTACGAGCAGTACTTC	CASSRRDRERFYEQYF	TRBV5-1	TRBJ2-7
TGTGCCAGCAGTCCGTCCCCCGAAAGATTCTATGGCTACACCTTC	CASSPSPERFYGYTF	TRBV27	TRBJ1-2
TGTGCCAGCAGTTCCGTGGAGCGGTTCTACGAGCAGTACTTC	CASSSVERFYEQYF	TRBV6-5	TRBJ2-7
TGCGCCACCCTACGGGAGAGGTTTTACGAGCAGTACTTC	CATLRERFYEQYF	TRBV10-1	TRBJ2-7
TGTGCCTGGACTCCTCCCGCAAAGGAGCGGTTTTACGAGCAGTACTTC	CAWTPPAKERFYEQYF	TRBV30	TRBJ2-7
TGTGCCAGCAGCCGGCGGGAGAGGTTCTACAATGAGCAGTTCTTC	CASSRRERFYNEQFF	TRBV5-4	TRBJ2-1
TGCGCCAGCAGCCAAGATGAGCTAGCGGAACGGTTCTACAATGAGCAGTTCTTC	CASSQDELAERFYNEQFF	TRBV4-3	TRBJ2-1
TGTGCCAGCAGCCCTATGGAACGTTTTTACACTGAAGCTTTCTTT	CASSPMERFYTEAFF	TRBV7-3	TRBJ1-1
TGTGCCAGCAGCGAAAGATTCTATCGACGCGGGCCCCAGCATTTT	CASSERFYRRGPQHF	TRBV5-5	TRBJ1-5
TGTGCCAGCAGCTTCACAGGGGACGGGGAACGTTTTTACGAGCAGTACTTC	CASSFTGDGERFYEQYF	TRBV5-6	TRBJ2-7
TGTGCCAGCAGTGAGAGGTTTTACCATCAAGAGACCCAGTACTTC	CASSERFYHQETQYF	TRBV6-4	TRBJ2-5
TGTGCCAGCAGCCTAATAGCGGGGGAGAGGTTCTACAATGAGCAGTTCTTC	CASSLIAGERFYNEQFF	TRBV3-1	TRBJ2-1
TGTGCCAGCACGCGGGAGGAGAGATTCTACAATGAGCAGTTCTTC	CASTREERFYNEQFF	TRBV7-2	TRBJ2-1
TGTGCCAGCAGCGACAGGGAGCGGTTCTACACTGAAGCTTTCTTT	CASSDRERFYTEAFF	TRBV11-2	TRBJ1-1
TGCGCCAGCAGCCCCCGAGAACGATTCTACGAGCAGTACTTC	CASSPRERFYEQYF	TRBV4-1	TRBJ2-7
TGTGCAGGAGCCGTTGAAAGGTTCTACGAGCAGTACTTC	CAGAVERFYEQYF	TRBV6-4	TRBJ2-7
TGTGCCTGGAGCTCAACAGGGGAGCGATTCTACGAGCAGTACTTC	CAWSSTGERFYEQYF	TRBV30	TRBJ2-7
TGTGCCACCAGTGAGACGACCAGGGAAAGGTTCTATGGCTACACCTTC	CATSETTRERFYGYTF	TRBV24-1	TRBJ1-2
TGTGCCAGCAGCGTAGTAAAATGGGGACTCGAGCGTTTCTACGAGCAGTACTTC	CASSVVKWGLERFYEQYF	TRBV9	TRBJ2-7
TGTGCCAGCAGCCAAGCTGGGGACAGGGACCGGGAACGGTTCTACGAGCAGTACTTC	CASSQAGDRDRERFYEQYF	TRBV3-1	TRBJ2-7
TGTGCCAGCAGTCGATCCGAAAGGTTTTACACCGGGGAGCTGTTTTTT	CASSRSERFYTGELFF	TRBV12-3	TRBJ2-2
TGTGCCAGCAGCCAAGACGAACAGGAAAGATTTTACTTC	CASSQDEQERFYF	TRBV14	TRBJ2-5
TGTGCCAGCAGCCAAGATAGCCGGGAGAGATTCTATGGCTACACCTTC	CASSQDSRERFYGYTF	TRBV14	TRBJ1-2
TGTGCCAGCAGTGACTCGAAGGGGGAGAGGTTTTATTCCGGGGAGCTGTTTTTT	CASSDSKGERFYSGELFF	TRBV6-4	TRBJ2-2
TGTGCCAGCAGCAGGGAGCAGGAGAGATTCTATGGCTACACCTTC	CASSREQERFYGYTF	TRBV6-5	TRBJ1-2
TGTGCCAGGGACAGGGAAAGATTCTATGGCTACACCTTC	CARDRERFYGYTF	TRBV4-2	TRBJ1-2
TGTGCCAGCAGTCCACACGAGCGGTTCTACGAGCAGTACTTC	CASSPHERFYEQYF	TRBV6-5	TRBJ2-7
TGTGCCAGCAGTGCGGACTGGGGCTGTCTTATCGAGCGATTCTACGAGCAGTACTTC	CASSADWGCLIERFYEQYF	TRBV27	TRBJ2-7
TGTGCCAGCTCACCACACAAGGGGTTGGCCGAAAGATTCTACGAGCAGTACTTC	CASSPHKGLAERFYEQYF	TRBV18	TRBJ2-7
TGTGCCAGCAGCTCACGGGGGGAACGGTTCTATGGCTACACCTTC	CASSSRGERFYGYTF	TRBV14	TRBJ1-2
TGTGCCAGCAGCTTAGCAGAGAGGTTTTATGTGACAGAGACGGAGGGTTCTAACTATGGCTACACCTTC	CASSLAERFYVTETEGSNYGYTF	TRBV7-2	TRBJ1-2
TGTGCCAGCAGTGGACCCCCAGACGAGCGTTTCTACGAGCAGTACTTC	CASSGPPDERFYEQYF	TRBV6-2	TRBJ2-7
TGTGCCAGCAGTTGGGGTAGGGAGAGGTTCTATGGCTACACCTTC	CASSWGRERFYGYTF	TRBV6-1	TRBJ1-2
TGTGCCAGTAGTATAGAAAGGGATTACCGTTGGAGTTGGTGGGAGAGGTTCTACGAGCAGTACTTC	CASSIERDYRWSWWERFYEQYF	TRBV19	TRBJ2-7
TGCGCCAGCGTAGATTTAGGGGAACGTTTCTATGGCTACACCTTC	CASVDLGERFYGYTF	TRBV10-1	TRBJ1-2
TGCAGCGGGACAGAGCGATTCTACACCTTC	CSGTERFYTF	TRBV29-1	TRBJ1-2
TGCAGTGCAGAGCGCTTTTACCCAGATACGCAGTATTTT	CSAERFYPDTQYF	TRBV20-1	TRBJ2-3
TGTGCCAGCAGTGACTCGACACCAATGAATAGGTTCGAGAGGTTCTACGAGCAGTACTTC	CASSDSTPMNRFERFYEQYF	TRBV6-4	TRBJ2-7
TGTGCCAGCAGTGAGCGGTTTTACTCCTACAATGAGCAGTTCTTC	CASSERFYSYNEQFF	TRBV28	TRBJ2-1
TGCAGTGCTAGAGCCCTTAGAGAACGGTTCTACGAGCAGTACTTC	CSARALRERFYEQYF	TRBV20-1	TRBJ2-7
TGTGCCAGCAGCTTAGGACAGCCTTCTGGGGAACGCTTCTATGGCTACACCTTC	CASSLGQPSGERFYGYTF	TRBV11-2	TRBJ1-2
TGTGCCAGCAGCTTAGCACCAGACAGGGAAAGGTTCTACGAGCAGTACTTC	CASSLAPDRERFYEQYF	TRBV7-4	TRBJ2-7
TGCAGTGCTGTTCTATCGGAAAGGTTCTACGAGCAGTACTTC	CSAVLSERFYEQYF	TRBV20-1	TRBJ2-7
TGTGCCTGTCGCGGAACAGGGGAGCGGTTCTACGAGCAGTACTTC	CACRGTGERFYEQYF	TRBV30	TRBJ2-7
TGTGCCAGCAGCAGTCCGGCGGGGGCCCGTGAAAGGTTCTACGAGCAGTACTTC	CASSSPAGARERFYEQYF	TRBV7-9	TRBJ2-7
TGTGCCGGATCCGAAAGGTTCTATACGCAGTATTTT	CAGSERFYTQYF	TRBV6-1	TRBJ2-3
TGTGCCAGCAGTTCAGAGGGTGGGGGCGAAAGGTTCTACGAGCAGTACTTC	CASSSEGGGERFYEQYF	TRBV28	TRBJ2-7
TGCGCCAGCAGCCAATCCCAGGAAAGGTTCTATGGCTACACCTTC	CASSQSQERFYGYTF	TRBV10-1	TRBJ1-2
TGTGCCAGCAGCAAGTGGGGGGAGCGATTCTATGGCTACACCTTC	CASSKWGERFYGYTF	TRBV5-4	TRBJ1-2
TGTGCCTGGAGTCAGACAGGGGAACGTTTCTACGAGCAGTACTTC	CAWSQTGERFYEQYF	TRBV30	TRBJ2-7
TGTGCCAGCAGTAGAGAGTACGAAAGGTTCTACGAGCAGTACTTC	CASSREYERFYEQYF	TRBV27	TRBJ2-7
TGTGCCAGCAGTTACCCTACTGCTCGACTAGCGGAAAGGTTCTACGAGCAGTACTTC	CASSYPTARLAERFYEQYF	TRBV6-8	TRBJ2-7
TGTGCCAGCACGATCGAGAGATTCTACGAGCAGTACTTC	CASTIERFYEQYF	TRBV3-1	TRBJ2-7
TGTGCCAGCAGTTATGGCACCAGAAGAGAACGATTCTACGAGCAGTACTTC	CASSYGTRRERFYEQYF	TRBV6-5	TRBJ2-7
TGTGCCAGCAGCCACGAACGTTTTTACACTGAAGCTTTCTTT	CASSHERFYTEAFF	TRBV7-2	TRBJ1-1
TGTGCCAGCAGTGAAAGATTCTATGGGACAGGGGGCTGGCCCTACGAGCAGTACTTC	CASSERFYGTGGWPYEQYF	TRBV27	TRBJ2-7
TGTGCCAGTAGTATGAACCAGGAGGAAAGGTTTTACTCCTATAATTCACCCCTCCACTTT	CASSMNQEERFYSYNSPLHF	TRBV19	TRBJ1-6
TGTGCCACCAGCAGACCGTGGACAGGTGAGCGGTTCTACGAGCAGTACTTC	CATSRPWTGERFYEQYF	TRBV15	TRBJ2-7
TGTGCCAGCAGGGAGAGGTTTTATGAAAAACTGTTTTTT	CASRERFYEKLFF	TRBV6-5	TRBJ1-4
TGTGCCAGCAGCTTCATGGGACTAGCGGAGCGATTTTATGAGCAGTTCTTC	CASSFMGLAERFYEQFF	TRBV7-7	TRBJ2-1
TGTGCCAGCAGCTTGACGGAAGAGAGGTTCTACGAGCAGTACTTC	CASSLTEERFYEQYF	TRBV11-3	TRBJ2-7
TGTGCCAGCAGACGGGGGGGAGAGAGGTTCTACGAGCAGTACTTC	CASRRGGERFYEQYF	TRBV5-4	TRBJ2-7
TGCAGCGTGTTCAGGGACCCTGAGAGATTCTATGGCTACACCTTC	CSVFRDPERFYGYTF	TRBV29-1	TRBJ1-2
TGTGCCAGCAGTTTAGCTCAATCTAGGGAACGCTTCTACGAGCAGTACTTC	CASSLAQSRERFYEQYF	TRBV28	TRBJ2-7
TGTGCCAGCAGCCCAGGGGAAAGGTTTTATAGCAATCAGCCCCAGCATTTT	CASSPGERFYSNQPQHF	TRBV7-3	TRBJ1-5
TGTGCCAGCAGCCCGCAGGGGGGAATGGAGCGCTTCTACGAGCAGTACTTC	CASSPQGGMERFYEQYF	TRBV27	TRBJ2-7
TGTGCCAGCAGCCAAGAAACAGAACCTATAGAGCGTTTCTACGAGCAGTACTTC	CASSQETEPIERFYEQYF	TRBV14	TRBJ2-7
TGCAGTGCTAGAGAAGAGAGGTTCTACGAGCAGTACTTC	CSAREERFYEQYF	TRBV20-1	TRBJ2-7
TGTGCCAGCAGTGACGAGCTTGAGCGTTTCTACGAGCAGTACTTC	CASSDELERFYEQYF	TRBV6-4	TRBJ2-7
TGCGCCAGCAGGGGACATGGAGAAAGGTTCTATCATGGCTACACCTTC	CASRGHGERFYHGYTF	TRBV5-1	TRBJ1-2
TGCAGCGTGCCAACCCCGGGACAGGGGGGAGAGCGCTTCTATGGCTACACCTTC	CSVPTPGQGGERFYGYTF	TRBV29-1	TRBJ1-2
TGCAGTGCTAGAGAGAGATTTTACTCCTACAATGAGCAGTTCTTC	CSARERFYSYNEQFF	TRBV20-1	TRBJ2-1
TGTGCCAGCAGCCAAGGACTCTCAGGGGAGAGATTCTACGAGCAGTACTTC	CASSQGLSGERFYEQYF	TRBV14	TRBJ2-7
TGTGCCAGCAGCCAGATAGAGCGGTTCTACGAGCAGTACTTC	CASSQIERFYEQYF	TRBV4-2	TRBJ2-7
TGCAGTGCTCGCTTTTTCGGCACAGGGGGCGAGCGGTTCTACGAGCAGTACTTC	CSARFFGTGGERFYEQYF	TRBV20-1	TRBJ2-7
TGCGCCAGCACGGGGACTAGCGGGGAAAGGTTCTACGAGCAGTACTTC	CASTGTSGERFYEQYF	TRBV10-1	TRBJ2-7
TGTGCCAGCAGCACTAAGCGGGAGCGATTCTATGGCTACACCTTC	CASSTKRERFYGYTF	TRBV5-6	TRBJ1-2
TGTGCCAGCAGCCTAACGGGGCGGGAGCGTTTCTACGAGCAGTACTTC	CASSLTGRERFYEQYF	TRBV28	TRBJ2-7
TGTGCCAGCAGTTCTGAGAGATTCTATTCTAGCACAGATACGCAGTATTTT	CASSSERFYSSTDTQYF	TRBV27	TRBJ2-3
TGTGCCAGCAGCCGGACCGGGACAGGGAGGGAAAGGTTTTATGAAAAACTGTTTTTT	CASSRTGTGRERFYEKLFF	TRBV7-3	TRBJ1-4
TGTGCCAGCAGCTTGCGGGAGCGTTTTTATAATGAAAAACTGTTTTTT	CASSLRERFYNEKLFF	TRBV7-9	TRBJ1-4
TGCGCCAGCAGCCTCATAGAAAGATTCTATGGCTACACCTTC	CASSLIERFYGYTF	TRBV5-1	TRBJ1-2
TGCAGTGCTGGACAGGCCGAACGATTCTACGAGCAGTACTTC	CSAGQAERFYEQYF	TRBV20-1	TRBJ2-7
TGCGCCAGCAGCTTGGGGAGGGGACTAGCGGGAGAGAGATTCTATAGCAATCAGCCCCAGCATTTT	CASSLGRGLAGERFYSNQPQHF	TRBV5-1	TRBJ1-5
TGTGCCAGCAGCGGAATCCAGGGGAGAGAAAGGTTCTACGAGCAGTACTTC	CASSGIQGRERFYEQYF	TRBV9	TRBJ2-7
TGCAGCGTTGAAGCCACCCAAGAGCGGTTCTACGAGCAGTACTTC	CSVEATQERFYEQYF	TRBV29-1	TRBJ2-7
TGCAGCGTTGAAACGTCTCAGCGGGAGCGGTTTTACGAGCAGTACTTC	CSVETSQRERFYEQYF	TRBV29-1	TRBJ2-7
TGCAGTGCTAGAGCAGGCCCCCGGGACAGGGAGACGGAGAGATTTTACGAGCAGTACTTC	CSARAGPRDRETERFYEQYF	TRBV20-1	TRBJ2-7
TGTGCCAGCCATGGGACAGGGCTCTTGTGCGAGAGATTCTATGGCTACACCTTC	CASHGTGLLCERFYGYTF	TRBV6-4	TRBJ1-2
TGCGCCAGCACCGACCGGACAGAGAGATTCTATGTATATTTT	CASTDRTERFYVYF	TRBV10-2	TRBJ1-3
TGCGCCAGCGACCCCTTATATGGGGGGCCGGAACGATTCTACGAGCAGTACTTC	CASDPLYGGPERFYEQYF	TRBV5-1	TRBJ2-7
TGTGCCAGTGGGCTTCGCGGGAGGGAGAGATTCTACAATGAGCAGTTCTTC	CASGLRGRERFYNEQFF	TRBV19	TRBJ2-1
TGTGCCAGCAGATCCCGCAGGGAACGTTTTTATGGCTACACCTTC	CASRSRRERFYGYTF	TRBV7-9	TRBJ1-2
TGCGCCAGCAGCCGGGTTCGGGAGCGGTTTTACAATGAGCAGTTCTTC	CASSRVRERFYNEQFF	TRBV4-3	TRBJ2-1
TGCGCCAGCAGCTTAGCGGAGCGGTTCTACAATGAGCAGTTCTTC	CASSLAERFYNEQFF	TRBV5-1	TRBJ2-1
TGTGCCAGCAGCTTGGAAGGGGAGAGGTTCTACGAGCAGTACTTC	CASSLEGERFYEQYF	TRBV5-4	TRBJ2-7
TGTGCCAGCAGTGACGAAGGGCGGGAGAGATTCTATGGCTACACCTTC	CASSDEGRERFYGYTF	TRBV6-4	TRBJ1-2
TGTGCCAGCAGCCAAGGAGGACAGGAACGGTTCTACGAGCAGTACTTC	CASSQGGQERFYEQYF	TRBV4-2	TRBJ2-7
TGTGCCAGCAGCCCCGATAGACTAGAGAGGTTTTATGAGCAGTTCTTC	CASSPDRLERFYEQFF	TRBV5-8	TRBJ2-1
TGCAGTGCTACGGGACAGGGGGGAGAAAGATTCTACGAGCAGTACTTC	CSATGQGGERFYEQYF	TRBV20-1	TRBJ2-7
TGTGCCAGCAGCGTAGAGGGTGCGGGGACAGAAAGATTCTATGGCTACACCTTC	CASSVEGAGTERFYGYTF	TRBV9	TRBJ1-2
TGTGCCAGCGACAACCGGGTGGAGAGGTTTTATAGCAATCAGCCCCAGCATTTT	CASDNRVERFYSNQPQHF	TRBV28	TRBJ1-5
TGTGCCACCGAAATCGCGGGGACCGAAAGGTTCTACGAGCAGTACTTC	CATEIAGTERFYEQYF	TRBV15	TRBJ2-7
TGTGCCAGCAGCGCCCTGACAGGGGAAAGATTTTACCACGAGCAGTACTTC	CASSALTGERFYHEQYF	TRBV7-4	TRBJ2-7
TGTGCCAGCAGCTTAGGGGACAGGGAGAGGTTCTACACCTTC	CASSLGDRERFYTF	TRBV11-3	TRBJ1-2
TGTGCCAGCAGCGTACGCGCCGAGCGGTTCTATGGCTACACCTTC	CASSVRAERFYGYTF	TRBV9	TRBJ1-2
TGCAGTGCTAGCAAACTAGAAAGATTCTACGAGCAGTACTTC	CSASKLERFYEQYF	TRBV20-1	TRBJ2-7
TGCAGCGTTCAGAGGCGTGAACGTTTTTACAATGAGCAGTTCTTC	CSVQRRERFYNEQFF	TRBV29-1	TRBJ2-1
TGCAGTGCTGAGGGCAGGGAGAGGTTCTATGGCTACACCTTC	CSAEGRERFYGYTF	TRBV20-1	TRBJ1-2
TGTGCCAGCAGACCTGAAAGATTCTACGAGCAGTACTTC	CASRPERFYEQYF	TRBV12-3	TRBJ2-7
TGTGCCAGCTCACCACCTCCCGAAAGATTCTACGAGCAGTACTTC	CASSPPPERFYEQYF	TRBV18	TRBJ2-7
TGTGCCAGCAGCAGGGAGGAGAGATTCTACACTGAAGCTTTCTTT	CASSREERFYTEAFF	TRBV7-3	TRBJ1-1
TGTGCCAGCAGCTTACGGAGGGAGCGATTCTATGGCTACACCTTC	CASSLRRERFYGYTF	TRBV7-9	TRBJ1-2
TGTGCCAGCAGCGTATCCAGGGGGCCGCGGTTGGAAAGGTTCTACGAGCAGTACTTC	CASSVSRGPRLERFYEQYF	TRBV11-2	TRBJ2-7
TGTGCCAGCAGTGAAGGTGGAACACAGGGAAGAGAACGATTTTATAGCAATCAGCCCCAGCATTTT	CASSEGGTQGRERFYSNQPQHF	TRBV2	TRBJ1-5
TGTGCCATCAGTGAGTCGTTTCACCTAGCGGAGAGATTTTACGAGCAGTACTTC	CAISESFHLAERFYEQYF	TRBV10-3	TRBJ2-7
TGTGCCAGCAGCTTGGGCAACAGGGAACGGTTCTACGAGCAGTACTTC	CASSLGNRERFYEQYF	TRBV5-6	TRBJ2-7
TGCGCCAGTGCCCTGGAGCGTTTCTATGGCTACACCTTC	CASALERFYGYTF	TRBV10-1	TRBJ1-2
TGTGCCAGCAGTGAACGCTTCTATCGCACAGATACGCAGTATTTT	CASSERFYRTDTQYF	TRBV25-1	TRBJ2-3
TGTGCCAGCAGAATGATTGGTGAACGATTCTATGGCTACACCTTC	CASRMIGERFYGYTF	TRBV6-5	TRBJ1-2
TGTGCCAGCAGCCGTAGACCCCCGCGGGAGGAGAGGTTCTACTCCTACAATGAGCAGTTCTTC	CASSRRPPREERFYSYNEQFF	TRBV13	TRBJ2-1
TGTGCCAAGGGACTAGAAAGGTTCTACGAGCAGTACTTC	CAKGLERFYEQYF	TRBV28	TRBJ2-7
TGCGCCGAGAGATTCTATAGCAATCAGCCCCAGCATTTT	CAERFYSNQPQHF	TRBV5-1	TRBJ1-5
TGTGCCAGCAGCTTGGCGGCAGGGCGAGAGAGGTTCTATGGCTACACCTTC	CASSLAAGRERFYGYTF	TRBV5-8	TRBJ1-2
TGCGCCAGCACTAGCAGAGAGACAGGGGAGAGGTTCTACGAGCAGTACTTC	CASTSRETGERFYEQYF	TRBV10-1	TRBJ2-7
TGTGCCAGCAGCTTACTGGAGGGGGCTGTGGAGAGGTTCTATGGCTACACCTTC	CASSLLEGAVERFYGYTF	TRBV11-2	TRBJ1-2
TGTGCCACCAGATTTGAGAGGTTCTACGAGCAGTACTTC	CATRFERFYEQYF	TRBV24-1	TRBJ2-7
TGTGCCAGCAGCGTAGAAGAGAGGTTCTATGGCTACACCTTC	CASSVEERFYGYTF	TRBV9	TRBJ1-2
TGCGCCAGCCCCCGAATTCTGGGGGAGAGATTCTACAATGAGCAGTTCTTC	CASPRILGERFYNEQFF	TRBV5-1	TRBJ2-1
TGCGCCAGCAGCGCTTGTGAGCGCTTTTATCAGCCCCAGCATTTT	CASSACERFYQPQHF	TRBV5-1	TRBJ1-5
TGTGCCAGTAGTATCCGCGTGCGAGCCTCGGGACGTGAGGAAAGGTTCTACGAGCAGTACTTC	CASSIRVRASGREERFYEQYF	TRBV19	TRBJ2-7
TGCGCCAGCAGCCAAGAAGGCGGGAGTGAGCGATTCTACGAGCAGTACTTC	CASSQEGGSERFYEQYF	TRBV4-1	TRBJ2-7
TGTGCCAGCTCACCCAAGACTCGACAGGAACAAGGCGAGAGGTTTTACACTGAAGCTTTCTTT	CASSPKTRQEQGERFYTEAFF	TRBV18	TRBJ1-1
TGTGCCAGCAGCGTGGGTGGAGGGGGGGAGCGATTCTACGAGCAGTACTTC	CASSVGGGGERFYEQYF	TRBV13	TRBJ2-7
TGTGCCAGCAGTGACCGACTAGCGGGAGAAAGATTCTACAATGAGCAGTTCTTC	CASSDRLAGERFYNEQFF	TRBV25-1	TRBJ2-1
TGCGCCAGCAGCCAAGAACTCGGGACAGGGGAGCTAGAGCGGTTTTACTATGGCTACACCTTC	CASSQELGTGELERFYYGYTF	TRBV4-1	TRBJ1-2
TGTGCCAGCAGTGACGTTAACACACTAGCGGGAGAGCGGTTCTACAATGAGCAGTTCTTC	CASSDVNTLAGERFYNEQFF	TRBV6-4	TRBJ2-1
TGTGCCAGCAGCCAATCCACGCGGGAGCGTTTTTACGAGCAGTACTTC	CASSQSTRERFYEQYF	TRBV14	TRBJ2-7
TGTGCCAGCAGTGATATCCCAGGGCGTGAGAGATTCTACGAGCAGTACTTC	CASSDIPGRERFYEQYF	TRBV25-1	TRBJ2-7
TGTGCCAGCAGTCTTTGGGAGAGGTTCTACAATGAGCAGTTCTTC	CASSLWERFYNEQFF	TRBV27	TRBJ2-1
TGTGCCAGCAGTTTTTCTGACAGGGGAGAGAGGTTCTATGGCTACACCTTC	CASSFSDRGERFYGYTF	TRBV27	TRBJ1-2
TGTGCCTCTGAACGTTTTTATGGCTACACCTTC	CASERFYGYTF	TRBV10-3	TRBJ1-2
TGTGCCAGCACTTCAAGGGGGGAGCGATTCTACGAGCAGTACTTC	CASTSRGERFYEQYF	TRBV9	TRBJ2-7
TGTGCCAGCAGTTTAGCTGGGTCGTGGGAGGAACGCTTCTACGAGCAGTACTTC	CASSLAGSWEERFYEQYF	TRBV12-4	TRBJ2-7
TGTGCCAGCAGCTTAGGGGAGTGGACAGAAAGATTTTATAATGAAAAACTGTTTTTT	CASSLGEWTERFYNEKLFF	TRBV7-7	TRBJ1-4
TGTGCCACTGGCATATTAGGACAGGAACGGTTCTACGAGCAGTACTTC	CATGILGQERFYEQYF	TRBV24-1	TRBJ2-7
TGTGCCAGCGGGGGCCGGGGGGAGCGTTTCTACGAGCAGTACTTC	CASGGRGERFYEQYF	TRBV6-2	TRBJ2-7
TGTGCCACCTGGGAGAGGTTCTACGAGCAGTACTTC	CATWERFYEQYF	TRBV24-1	TRBJ2-7
TGTGCCAGCAGCGTACGGGAGAGATTTTACACTAGGGGTGCAACTAATGAAAAACTGTTTTTT	CASSVRERFYTRGATNEKLFF	TRBV14	TRBJ1-4
TGCGCCAGCAGCGCAGGGGGCAACAGGGGTCCTGAAAGGTTTTACTATCAGCCCCAGCATTTT	CASSAGGNRGPERFYYQPQHF	TRBV5-1	TRBJ1-5
TGCGCCAGCAGCTTGCCAGTCGAGCGTTTCTACGAGCAGTACTTC	CASSLPVERFYEQYF	TRBV5-1	TRBJ2-7
TGTGCCAGCAACTTGTGGGGGGAACGGTTCTATGGCTACACCTTC	CASNLWGERFYGYTF	TRBV2	TRBJ1-2
TGTGCCAGCAGTAGTCCCCCAGTTGAGAGGTTCTATGGCTACACCTTC	CASSSPPVERFYGYTF	TRBV27	TRBJ1-2
TGCGCCAGCAGCCAAGAGCGGTTCTATGCCGATTACTTC	CASSQERFYADYF	TRBV4-1	TRBJ2-5
TGTGCCAGCAGTGAGATTACAGGGGAGAGGTTCTACGAGCAGTACTTC	CASSEITGERFYEQYF	TRBV6-2	TRBJ2-7
TGTGCCAGCAGTGATTGGACAGAGCCCCCGGTGGAAAGGTTCTACGAGCAGTACTTC	CASSDWTEPPVERFYEQYF	TRBV25-1	TRBJ2-7
TGCAGTGCAAGCAGGGAGAGATTCTACAATGAGCAGTTCTTC	CSASRERFYNEQFF	TRBV20-1	TRBJ2-1
